a	ʔaː	5
a	a	5
a	ä	5
à	a	1
aa	aʔa	1
aa	aː	1
aachen	aːxən	1
aaron	ʔaːʀɔn	1
ab	ap	106
ab	ɑp	106
ab	ɑb̥	106
abberufung	apbəʁuːfʊŋ	1
abbezahlen	abətsaːlən	1
abbremsen	abʁɛmzən	1
abbruch	apbʁʊχ	1
abbruch	apʁʊχ	1
abdeckung	apdɛkʊŋ	1
abdruck	apdʁʊk	1
abend	aːbənt	20
abend	aːmt	20
abends	aːbənts	6
abenteuer	aːbəntɔʏ̯ɐ	4
abenteuerlich	ʔaːbm̩tɔɪ̯ɐlɪç	1
abenteuerlich	ʔaːbəntɔɪ̯ɐlɪç	1
aber	aːbɐ	541
aber	abɐ	541
aber	aːbɐ	541
abfinden	apfɪndən	1
abflug	ʔapfluːk	2
abgabe	apɡaːbə	2
abgang	apɡaŋ	4
abgeneigt	apɡənaɪ̯kt	1
abgeschlossen	ʔapɡəʃlɔsn̩	11
abgeschlossen	ʔapɡəʃlɔsən	11
abhängen	ʔaphɛŋən	2
abhängig	aphɛŋɪç	9
abholen	ʔaphoːln̩	1
abholen	ʔaphoːlən	1
abholzung	aphɔltsʊŋ	1
abhören	aphøːʁən	1
abi	abi	1
abkommen	apkɔmən	5
abkommen	ʔapkɔmən	5
abkühlen	apkyːlən	1
abkühlung	ʔapkyːlʊŋ	1
abkupfern	ʔapkʊpfɐn	1
abkürzung	apkʏʁtsʊŋ	1
ableger	apleːɡɐ	3
ablehnen	apleːnən	3
ablenken	aplɛŋkən	1
ablenkung	aplɛŋkʊŋ	1
ablenkungsmanöver	aplɛŋkʊŋsmanøːvɐ	1
abliefern	apliːfɐn	1
ablösen	apløːzən	1
ablösung	apløːzʊŋ	1
abmelden	apmɛldən	1
abnehmer	apneːmɐ	2
abonnieren	abɔniːʁən	4
abordnung	apʔɔʁtnʊŋ	1
abpfiff	ʔappfɪf	1
abrede	ʔapʀeːdə	1
abreiben	ʔapʀaɪ̯bm̩	1
abreiben	ʔapʀaɪ̯bən	1
abreisen	ʔapʀaɪ̯zn̩	1
abreisen	ʔapʀaɪ̯zən	1
abreisen	ʔapʀaɪ̯zn̩	1
abreisen	ʔapʀaɪ̯zən	1
abrufen	apʁuːfən	3
abrüstung	apʀʏstʊŋ	1
absage	apsaːɡə	4
absagen	apzaːɡn̩	3
absagen	apzaːɡn̩	3
absatz	apzat͡s	3
abschaffen	apʃafən	2
abschaffung	apʃafʊŋ	2
abschieben	ʔapʃiːbən	2
abschieben	ʔapʃiːbm̩	2
abschirmen	apʃɪʁmən	1
abschliessen	ʔapʃliːsn̩	1
abschliessen	ʔapʃliːsən	1
abschluss	apʃlʊs	6
abschneiden	ʔapʃnaɪ̯dn̩	2
abschneiden	ʔapʃnaɪ̯dən	2
abschottung	apʃɔtʊŋ	3
abschrecken	apʃʁɛkən	1
abschreckung	apʃʀɛkʊŋ	1
abschreibung	apʃʁaɪ̯bʊŋ	1
abschuss	apʃʊs	3
abschwächen	apʃvɛçn̩	1
abschwung	apʃvʊŋ	1
abseits	apzaɪ̯ts	6
abseits	apzaɪ̯t͡s	6
absetzen	apsɛtsən	1
absichtlich	apzɪçtlɪç	2
absichtlich	apsɪçtlɪç	2
absolut	apzoluːt	6
absorption	apzɔʁpt͡si̯oːn	1
absprache	apʃpʁaːxə	1
abstecher	apʃtɛçɐ	2
abstellen	apʃtɛlən	2
abstieg	apʃtiːk	1
abstieg	apʃtiːç	1
abstimmen	apʃtɪmən	2
abstimmung	ʔapʃtɪmʊŋ	7
abstinenz	apstinɛnts	1
abstreifen	apʃtʁaɪ̯fən	1
absturz	apʃtʊʁts	11
absuchen	ʔapzuːxən	1
abtropfen	aptʁɔp͡fn̩	1
abwägen	apveːɡən	1
abwägen	apveːɡn̩	1
abwarten	apvaʁtən	3
abwechslung	apvɛkslʊŋ	2
abwehrspieler	apvɛɐ̯ʃpiːlɐ	4
abweisen	apvaɪ̯zən	1
abwerten	apveːʁtən	1
abwickeln	ʔapvɪkl̩n	1
abwickeln	ʔapvɪkəln	1
abwiegen	apviːɡən	1
ach	ax	4
ach	ax	4
acht	axt	29
achten	axtən	3
achterbahn	ʔaxtɐbaːn	1
achtmal	axtmaːl	1
achtsamkeit	aχtzaːmkaɪ̯t	2
ackern	ʔakɐn	2
action	ɛktʃən	4
adäquat	adɛkvaːt	1
adele	adeːlə	1
adobe	adoːbə	1
adria	aːdʁia	1
adrian	adʁiaːn	1
advent	ʔatvɛnt	1
affäre	afɛːʀə	2
afrika	afʁika	15
afrika	aːfʁika	15
after	aftɐ	1
after	aːftɐ	1
agenda	aɡɛnda	4
agentur	aɡɛntuːɐ̯	5
aggressiv	aɡʁɛsiːf	5
agieren	aɡiːɐ̯n	5
agieren	aɡiːʀən	5
ägypten	ɛɡʏptn̩	3
ähneln	ʔɛːnl̩n	1
ähneln	ʔɛːnəln	1
ahnen	ʔaːnən	1
ähnlich	ɛːnlɪç	19
ahnung	ʔaːnʊŋ	2
ahnungslos	aːnʊŋsloːs	1
akademie	akademiː	3
akribie	akʀibiː	3
akribisch	akʁiːbɪʃ	1
akt	akt	2
aktie	aktsi̯ə	18
aktivieren	aktiviːʀən	6
aktuell	aktu̯ɛl	13
akzeptieren	akt͡sɛptiːʀən	5
alarm	alaʁm	1
alaska	alaska	1
aleppo	alɛpo	3
algorithmen	ʔalɡoʀɪtmən	1
alice	aliːsə	1
alice	aliːs	1
alkohol	alkohoːl	5
alkohol	alkohoːl	5
alkoven	alkoːvən	1
all	al	20
allah	ala	1
allah	alaː	1
alle	alə	191
allein	alaɪn	25
allem	aləm	95
allemal	aləmaːl	1
allemal	aləmaːl	1
allen	alən	43
aller	alɐ	40
allerdings	ʔalɐdɪŋs	115
allerdings	ʔalɐdɪŋs	115
allergisch	alɛʁɡɪʃ	1
allerlei	alɐlaɪ̯	1
alles	aləs	97
allesamt	aləzamt	2
allianz	ali̯ant͡s	5
alltag	altaːk	4
alltag	altaːɡ	4
alltag	altak	4
alpen	ʔalpən	4
alptraum	alptʁaʊ̯m	1
als	als	810
also	ʔalzoː	82
alt	alt	11
alt	ʔalt	11
alte	altə	25
alten	ʔaltn̩	22
alten	ʔaltən	22
alter	ʔaltɐ	11
alter	altər	11
alter	altər	11
älter	ʔɛltɐ	4
altersgruppen	altɐsɡʀʊpn̩	1
ältesten	ʔɛltəstn̩	1
ältesten	ʔɛltəstən	1
aluminium	ʔalumiːni̯ʊm	1
am	am	665
amerika	ameːʀika	4
amerikaner	ameʁikaːnɐ	11
ammoniak	amonjak	1
ammoniak	amɔnjak	1
ampel	ʔampl̩	1
ampel	ʔampəl	1
ampeln	ʔampl̩n	1
ampeln	ʔampəln	1
amt	amt	12
amtseid	amt͡sʔaɪ̯t	1
amtsleiter	amt͡slaɪ̯tɐ	1
an	an	624
analysieren	analyːziːʀən	3
analysis	anaːlyzɪs	1
anbau	anbaʊ̯	1
anbieten	ʔanbiːtn̩	11
anbieten	ʔanbiːtən	11
anblick	ʔanblɪk	2
anbringen	ʔanbʀɪŋən	1
andalusien	ˀandaluːzi̯ən	1
andere	ʔandəʀə	93
anderer	andərər	15
anderer	andərər	15
ändern	ʔɛndɐn	19
anderthalb	andərthalb	2
anderthalb	andərthalb	2
andré	andʁe	6
anerkennen	anʔɛrkɛnən	4
anerkennen	anər-	4
anfang	anfaŋ	50
anfangen	anfaŋən	5
anfänger	anfɛŋɐ	1
anfechten	anfɛçtən	1
anflug	anfluːk	1
anfragen	anfʁaːɡŋ̍	3
anführer	anfyːrɐ	3
anführer	ɑnfyːrər	3
angeben	ʔanɡeːbm̩	4
angeben	ʔanɡeːbən	4
angeblich	anɡeːplɪç	14
angebot	ʔanɡəboːt	26
angehen	anɡeːən	1
angel	aŋl̩	2
angela	aŋɡeːla	17
angela	aŋɡela	17
angela	aŋəla	17
angelegenheit	anɡəleːɡn̩ha͜it	2
angelpunkt	aŋl̩pʊŋkt	1
angenehm	ʔanɡəneːm	1
angesichts	ʔanɡəzɪçts	31
angewiesen	anɡəviːzn̩	4
angreifen	anɡʁaɪ̯fən	2
angreiferin	ʔanɡʀaɪ̯fəʀɪn	1
angriff	anɡʀɪf	15
anhalt	anhalt	1
anhalten	ʔanhaltn̩	1
anhalten	ʔanhaltən	1
anhänger	anhɛŋɐ	8
anheben	anheːbən	1
anhören	ʔanhøːʁən	1
anita	ʔaniːta	2
anklagen	anklaːɡən	2
ankläger	anklɛːɡɐ	1
ankommen	ʔankɔmən	2
ankündigen	ankʏndɪɡn̩	3
ankündigung	ankʏndɪɡʊŋ	3
anlagen	anlaːɡən	2
anlegen	ʔanleːɡŋ̩	3
anlegen	ʔanleːɡən	3
anleger	anleːɡɐ	11
anliegen	anliːɡn̩	2
anmachen	anmaχən	1
anmachen	anmaχn	1
anmelden	ʔanmɛldn̩	2
anmelden	ʔanmɛldən	2
anmuten	anmuːtn̩	1
anna	ʔana	2
annäherung	annɛːəʁʊŋ	1
annahme	annaːmə	3
anne	ʔanə	3
anpassen	anpasən	2
anpfiff	ʔanpfɪf	1
anrecht	anʀɛçt	1
anreise	anʀaɪ̯zə	1
anreiz	anʀaɪ̯t͡s	4
ansässig	anzɛsɪç	1
ansatz	anzats	3
anschauen	ʔanʃaʊ̯ən	5
anscheinend	anʃaɪnənt	7
anschliessend	ʔanʃliːsn̩t	5
anschliessend	ʔanʃliːsənt	5
anschluss	anʃlʊs	6
ansehen	ʔanzeːən	8
ansehen	anzeːən	8
ansicht	ʔanzɪçt	7
anstand	anʃtant	2
ansteigen	ʔanʃtaɪ̯ɡŋ̩	1
ansteigen	ʔanʃtaɪ̯ɡən	1
anstellen	ʔanʃtɛln̩	2
anstellen	ʔanʃtɛlən	2
anstreben	anʃtʁeːbən	2
anstrengen	anʃtʁɛŋən	2
anteil	ʔantaɪ̯l	8
anteilnahme	antaɪ̯lnaːmə	1
antenne	antɛnə	3
antifa	antifaː	1
antike	antiːkə	1
antje	ʔantjə	2
antreten	antʁeːtən	3
antun	ʔantuːn	2
antwort	antvɔʁt	38
antworten	antvɔʁtən	22
anwalt	anvalt	10
anwältin	anvɛltɪn	1
anweisung	ʔanvaɪ̯zʊŋ	1
anweisungen	ʔanvaɪ̯zʊŋən	3
anwenden	ʔanvɛndn̩	1
anwenden	ʔanvɛndən	1
anwender	ʔanvɛndɐ	7
anwenders	ʔanvɛndɐs	1
anwendung	ʔanvɛndʊŋ	5
anwendungen	ʔanvɛndʊŋən	4
anzahl	antsaːl	12
anzeichen	ʔantsaɪ̯çn̩	3
anzeichen	ʔantsaɪ̯çən	3
anzeige	ant͡saɪ̯ɡə	30
anzeigen	ʔantsaɪ̯ɡŋ̩	19
anzeigen	ʔantsaɪ̯ɡən	19
anzug	antsuːk	1
apotheke	apoteːkə	1
app	ɛp	23
appel	apl̩	1
appetit	apətiːt	1
appetit	apətɪt	1
apps	ɛps	9
april	apʁɪl	28
arbeiten	aʁbaɪ̯tən	29
arbeiten	ʔaʁbaɪ̯tn̩	29
arbeiten	ʔaʁbaɪ̯tən	29
arbeiter	ʔaʁbaɪ̯tɐ	2
arbeitslos	aʁbaɪ̯tsloːs	1
arbeitslosigkeit	aʁbaɪ̯tsloːzɪçkaɪ̯t	3
arbeitsplatz	ʔaʁbaɪ̯tsplats	5
arbeitsspeicher	arbaɪ̯t͡sʃpaɪ̯çɐ	3
architekt	aʁçitɛkt	2
architektin	aʁçitɛktɪn	1
archiv	aʁçiːf	7
areal	aʁeaːl	4
arena	aʁeːna	5
ärger	ʔɛɐ̯ɡɐ	7
ärgern	ʔɛɐ̯ɡɐn	1
argument	arɡumɛnt	2
arm	ʔaʁm	3
arm	ʔaːm	3
arme	aːɐ̯mə	2
armee	aʁmeː	6
armee	ameː	6
aroma	ʔaʀoːma	1
aromen	ʔaʀoːmən	1
arrest	aʁɛst	1
arrogant	aʁoɡant	1
arroganz	aʁoɡant͡s	1
arsch	ʔaʁʃ	1
arsch	ʔaːʃ	1
art	ʔaːʁt	29
art	ʔaːt	29
artikel	aʁtɪkəl	53
artikel	aʁtiːkəl	53
arzt	aːɐ̯tst	3
arzt	aːtst	3
ärzte	ɛːɐ̯t͡stə	11
aschewolke	aʃəvɔlkə	1
aso	azoː	1
aspekt	ʔaspɛkt	1
ass	ʔas	1
assistenten	asɪstɛntən	3
assistentin	asɪstɛntɪn	1
assyrer	asyːʀɐ	1
astronom	ʔastʀonoːm	1
asylbewerber	azyːlbəvɛrbɐ	4
asylrecht	azyːlʁɛçt	2
asylsuchender	azyːlzuːxn̩dɐ	3
asylwerber	azyːlvɛrbɐ	1
atelier	atəli̯eː	1
atem	aːtəm	2
athen	ateːn	13
äthiopien	ɛti̯oːpi̯ən	1
atmen	aːtmən	1
atmen	aːpmən	1
atmen	aːtmən	1
atmosphäre	ʔatmosfɛːʀə	4
atomkraftwerk	atoːmkʁaftvɛʁk	1
attackieren	atakiːʁən	1
attentäter	atəntɛːtɐ	6
attentäter	atənteːtɐ	6
attraktion	atʀakt͡si̯oːn	1
au	aʊ̯	1
auch	aʊ̯x	987
auch	aʊ̯	987
audi	aʊ̯di	6
aue	aʊ̯ə	1
auf	aʊ̯f	1398
aufbauen	aʊ̯fbaʊ̯ən	3
aufenthalt	aʊ̯fʔɛnthalt	2
aufenthalt	aʊ̯fənthalt	2
auferstehung	aʊ̯fɛʁʃteːʊŋ	1
auffahren	aʊ̯ffaːʁən	1
auffassung	aʊ̯ffasʊŋ	5
aufgabe	ʔaʊ̯fɡaːbə	11
aufgeben	aʊ̯fɡeːbm̩	5
aufgeben	aʊ̯fɡeːbən	5
aufgrund	a͡ʊfɡrʊnt	23
aufheben	aʊ̯fheːbm	1
aufheben	aʊ̯fheːbən	1
aufhetzen	aʊ̯fhɛt͡sn̩	1
aufklären	aʊfklɛːʁən	1
aufklären	aʊfklɛɐ̯n	1
aufklärung	aʊ̯fklɛːʁuŋ	6
aufkleber	aʊ̯fkleːbɐ	1
auflage	aʊ̯flaːɡə	1
auflistung	aʊ̯flɪstʊŋ	1
auflösen	ʔaʊ̯fløːzn̩	1
auflösen	ʔaʊ̯fløːzən	1
auflösung	aʊ̯fløːzʊŋ	5
aufmarsch	aʊ̯fmaʁʃ	3
aufmerksam	aʊ̯fmɛʁkzaːm	4
aufmerksamkeit	aʊ̯fmɛʁkzaːmkaɪ̯t	4
aufnahme	aʊ̯fnaːmə	8
aufnehmen	ʔaʊ̯fneːmən	8
aufpreis	aʊ̯fpʀaɪ̯s	1
aufregen	aʊ̯fʀeːɡn̩	2
aufregung	aʊ̯fʀeːɡʊŋ	2
aufruf	aʊ̯fʀuːf	2
aufruhr	aʊ̯fʁuːɐ̯	3
aufrüsten	aʊ̯fʁʏstən	1
aufs	aʊ̯fs	15
aufschlag	aʊ̯fʃlaːk	1
aufschlagen	ʔaʊ̯fʃlaːɡŋ̩	1
aufschlagen	ʔaʊ̯fʃlaːɡən	1
aufschwung	aʊ̯fʃvʊŋ	2
aufseher	ʔaʊ̯fzeːɐ	1
aufsetzen	aʊ̯fzɛt͡sən	1
aufsichtsrat	ʔaʊ̯fzɪçtsʀaːt	3
aufsteigen	ʔaʊ̯fʃtaɪ̯ɡŋ̩	2
aufsteigen	ʔaʊ̯fʃtaɪ̯ɡən	2
aufstellen	ʔaufʃtɛlən	2
aufstieg	aʊ̯fʃtiːk	5
aufstieg	aʊ̯fʃtiːç	5
auftauen	aʊ̯ftaʊ̯ən	1
auftauen	aʊ̯ftaʊ̯ən	1
aufteilung	aʊ̯ftaɪ̯lʊŋ	4
auftrag	ʔaʊ̯ftʁaːk	9
auftrag	ʔaʊ̯ftʁax	9
auftrag	ʔaʊ̯ftʁaːx	9
auftritt	aʊftʀɪt	12
aufwändig	ʔaʊ̯fvɛndɪç	1
aufwärts	aʊ̯fvɛʁt͡s	2
aufwerten	aʊ̯fveːʁtən	1
aufwertung	aʊ̯fveːɐ̯tʊŋ	1
auge	aʊ̯ɡə	3
augen	ʔaʊ̯ɡŋ̩	14
augen	ʔaʊ̯ɡən	14
augenblick	aʊɡənblɪk	1
augenblick	aʊɡənblɪk	1
augenmerk	aʊ̯ɡənmɛʁk	1
augenzwinkern	aʊ̯ɡn̩t͡svɪŋkɐn	1
august	aʊ̯ɡʊst	34
august	aʊ̯ɡʊst	34
aus	aʊs	633
ausblenden	ʔaʊ̯sblɛndn̩	3
ausblenden	ʔaʊ̯sblɛndən	3
ausbund	ʔaʊsbʊnd	1
auschwitz	ʔaʊ̯ʃvɪts	1
ausdenken	aʊ̯sdɛŋkən	1
ausdrücke	aʊsdʁʏkə	1
ausfall	aʊ̯sfal	4
ausflug	ʔaʊ̯sfluːk	2
ausflüge	ʔaʊ̯sflyːɡə	1
ausführte	aʊsfyːɐ̯tə	1
ausführungen	ʔaʊ̯sfyːʀʊŋən	4
ausfüllen	aʊ̯sfʏlən	1
ausgang	ʔaʊ̯sɡaŋ	6
ausgeben	aʊ̯sɡeːbən	4
ausgehen	ʔaʊ̯sɡeːən	8
ausgleich	aʊ̯sɡlaɪ̯ç	4
ausgrabungen	ʔaʊ̯sɡʀaːbʊŋən	1
aushalten	ʔaʊ̯shaltn̩	2
aushalten	ʔaʊ̯shaltən	2
auskommen	ʔaʊ̯skɔmən	3
auskommen	ʔaʊ̯skɔmən	3
auslagern	ʔaʊ̯slaːɡɐn	1
ausland	aʊ̯slant	15
ausländer	aʊ̯slɛndɐ	9
auslassen	ʔaʊ̯slasn̩	3
auslassen	ʔaʊ̯slasən	3
auslaufen	ʔaʊ̯slaʊ̯fɱ̩	1
auslaufen	ʔaʊ̯slaʊ̯fən	1
ausleben	aʊ̯sleːbn̩	1
ausleihen	aʊslaɪən	1
ausliefern	ʔaʊ̯sliːfɐn	1
ausmachen	ʔaʊ̯smaxn̩	3
ausmachen	ʔaʊ̯smaxən	3
ausmass	aʊ̯smaːs	4
ausnahme	aʊ̯snaːmə	2
ausnutzen	aʊ̯snʊtsən	1
ausprobieren	ʔaʊ̯spʀobiːɐ̯n	1
ausprobieren	ʔaʊ̯spʀobiːʀən	1
aussagen	aʊ̯szaːɡən	13
ausschau	aʊ̯sʃaʊ̯	2
ausscheiden	ʔaʊ̯sʃaɪ̯dn̩	4
ausscheiden	ʔaʊ̯sʃaɪ̯dən	4
ausschnitt	aʊ̯sʃnɪt	1
ausschütten	aʊ̯sʃʏtn̩	1
aussehen	aʊ̯szeːən	7
aussehen	aʊ̯seːn	7
ausser	aʊ̯sɐ	2
aussergewöhnlich	aʊ̯sɐɡəvøːnlɪç	1
ausserhalb	aʊ̯sɐhalp	2
äussern	ɔʏ̯sɐn	1
äusserst	ɔʏ̯sɐst	1
aussperren	aʊ̯sʃpɛʀən	1
aussprache	aʊ̯sʃpʁaːxə	1
ausstellung	aʊ̯sʃtɛlʊŋ	6
ausstrahlen	aʊ̯sʃtʁaːlən	2
aussuchen	aʊ̯szuːχn̩	1
austausch	aʊ̯staʊ̯ʃ	3
australien	aʊstʁaːli̯ən	14
ausüben	ʔaʊ̯sʔyːbm̩	2
ausüben	ʔaʊ̯sʔyːbən	2
auswahl	aʊ̯svaːl	4
auswählen	aʊ̯svɛːlən	1
auswärts	aʊ̯svɛrts	3
ausweg	ʔaʊ̯sveːk	2
ausweisung	ʔaʊ̯svaɪ̯zʊŋ	1
auswendig	aʊ̯svɛndɪç	1
auszahlen	aʊ̯stsaːlən	1
auszeichnung	aʊ̯stsaɪ̯çnʊŋ	3
ausziehen	ʔaʊ̯stsiːən	1
auto	aʊ̯toː	34
autobahnen	ʔaʊ̯tobaːnən	1
autokratie	aʊ̯tokʀatiː	1
automat	aʊ̯tomaːt	1
autonomie	aʊ̯tonomiː	1
autor	aʊ̯toːɐ̯	4
autorin	ʔaʊ̯toːʀɪn	3
autos	aʊ̯tos	20
b	beː	5
babysitter	beːbisɪtɐ	1
bach	baχ	3
bachelor	bɛt͡ʃəlɐ	1
bachelor	bɛt͡ʃlɐ	1
back	bak	1
back	bak	1
back	bɛk	1
backen	bakən	1
bäcker	bɛkɐ	2
bad	baːt	10
bad	bat	10
baden	baːdən	3
baden	baːdən	3
bagdad	bakdat	3
bagger	baɡɐ	1
bahnfahrt	baːnfaːɐ̯t	1
bahnhof	baːnhoːf	7
bahnsteig	baːnʃtaɪ̯k	2
bahrain	baʁaɪ̯n	2
bahrain	baχʁaɪ̯n	2
bald	balt	23
balkan	balkaːn	2
ball	bal	9
banane	banaːnə	1
bananen	banaːnən	1
band	bant	6
band	bɛnt	6
band	bɛːnt	6
bande	bandə	1
bands	bants	1
bands	bɛnts	1
bangen	baŋn̩	2
bangladesch	baŋladɛʃ	1
bank	baŋk	15
banken	baŋkən	24
banker	bɛŋkɐ	1
banker	baŋkɐ	1
bankrott	baŋkʀɔt	1
bann	ban	1
banner	banɐ	1
bär	bɛːɐ̯	2
bären	bɛːʀən	2
bären	bɛːɐ̯n	2
bargeld	baːɐ̯ɡɛlt	1
barmherzigkeit	baʁmhɛʁt͡sɪçkaɪ̯t	2
bart	bart	2
bart	bart	2
bart	bart	2
basiert	baziːɐ̯t	4
basis	baːzɪs	7
basketball	baːskətbal	4
basteln	bastəln	1
bau	baʊ̯	9
bauch	baʊ̯x	1
bauer	baʊ̯ɐ	4
bauern	baʊ̯ɐn	11
baujahr	baʊ̯jaːɐ̯	1
baumarkt	baʊ̯maʁkt	1
baumarkt	baʊ̯maːkt	1
bäume	bɔʏmə	4
baustein	baʊ̯ʃtaɪ̯n	1
baustelle	baʊ̯ʃtɛlə	3
bauweise	baʊ̯vaɪ̯zə	1
bayern	baɪ̯ɐn	41
beachten	bəʔaχtn̩	5
beamer	biːmɐ	1
beamte	bəʔamtə	2
beamte	biːmtə	2
beantworten	bəʔantvɔɐ̯tn̩	8
beantworten	bəʔantvɔɐ̯tən	8
beantworten	bəʔantvɔʁtn̩	8
beantworten	bəʔantvɔʁtən	8
bearbeitung	bəʔaʁbaɪ̯tʊŋ	1
beäugen	bəʔɔɪ̯ɡn̩	1
beben	beːbən	3
becher	bɛçɐ	1
becken	bɛkən	2
bedacht	bədaxt	2
bedacht	bədaxt	2
bedarf	bədaʁf	8
bedauerlicherweise	bədaʊ̯ɐlɪçɐvaɪ̯zə	1
bedauern	bədaʊ̯ɐn	5
bedenken	bədɛŋkŋ̍	3
bedenken	bədɛŋkən	3
bedenken	bədɛŋkn̩	3
bedeuten	bədɔɪ̯tn̩	8
bedeuten	bədɔɪ̯tən	8
bedeutend	bədɔɪ̯tn̩t	1
bedeutend	bədɔɪ̯tənt	1
bedeutender	bədɔɪ̯tn̩dɐ	3
bedeutender	bədɔɪ̯təndɐ	3
bedeutung	bədɔʏ̯tʊŋ	9
bedeutungen	bədɔɪ̯tʊŋən	1
bedient	bədint	4
bedingen	bədɪŋən	1
bedingung	bədɪŋʊŋ	2
bedrohen	bədʁoːən	2
beeilen	bəʔaɪ̯lən	1
beeinflussen	bəʔaɪ̯nflʊsn̩	2
beethoven	beːthoːfn̩	1
befassen	bəfasn̩	4
befehle	bəfeːlə	2
befinden	bəfɪndən	7
befinden	bəfɪndn̩	7
befinden	bəfɪndən	7
beflügeln	bəflyːɡl̩n	2
befördern	bəfœrdərn	1
befragung	bəfʀaːɡʊŋ	2
befreien	bəfʀaɪ̯ən	4
befruchtung	bəfʀʊχtʊŋ	2
befund	bəfʊnt	1
befürworter	bəfyːɐ̯vɔʁtɐ	1
begegnen	bəɡeːɡnən	3
begegnung	bəɡeːɡnʊŋ	5
begehren	bəɡeːʀən	2
begehren	bəɡeːʀn̩	2
begehren	bəɡeːʀən	2
begeistern	bəɡaɪ̯stɐn	1
begeistert	bəɡaɪ̯stɐt	9
begeisterung	bəɡaɪ̯stəʀʊŋ	3
beginn	bəɡɪn	30
beginne	bəɡɪnə	1
beginnen	bəɡɪnən	6
beginnend	bəɡɪnənt	1
begleiten	bəɡlaɪ̯tən	1
begleiter	bəɡlaɪ̯tɐ	5
begleitungen	bəɡlaɪ̯tʊŋən	1
begonnen	bəɡɔnən	14
begraben	bəɡʀaːbm̩	3
begraben	bəɡʀaːbən	3
begreifen	bəɡʁaɪ̯fən	3
begrenzen	bəɡʀɛntsn̩	1
begrenzen	bəɡʀɛntsən	1
begriff	bəɡʀɪf	2
begriffe	bəɡʀɪfə	1
begutachtung	bəɡuːtaχtʊŋ	2
behälter	bəhɛltɐ	3
behandlung	bəhandlʊŋ	3
behandlungen	bəhandlʊŋən	1
behaupten	bəhaʊ̯ptən	4
beheben	bəheːbən	1
behebung	bəheːbʊŋ	1
behelfen	bəhɛlfən	1
beherrschung	bəhɛʁʃʊŋ	1
beherzigen	bəhɛʁt͡sɪɡn̩	1
behindern	bəhɪndɐn	2
behörde	bəhøːɐ̯də	7
behörde	bəhœʁdə	7
behutsam	bəhuːtzaːm	1
bei	baɪ̯	757
beide	baɪ̯də	33
beifahrer	baɪ̯faːʀɐ	2
beihilfe	baɪ̯hɪlfə	1
beilegung	baɪ̯leːɡʊŋ	1
beim	baɪ̯m	208
beinahe	baɪ̯naːə	4
beispiel	baɪ̯ʃpiːl	46
beispielsweise	baɪ̯ʃpiːlsvaɪ̯zə	28
beitrag	baɪ̯tʀaːk	6
beitrag	baɪ̯tʀax	6
beitrag	baɪ̯tʀaːx	6
beitritt	baɪ̯trɪt	1
bekämpft	bəkɛmft	2
bekämpfung	bəkɛmpfʊŋ	4
bekannt	bəkant	45
bekanntheit	bəkanthaɪ̯t	2
bekanntlich	bəkantlɪç	2
beklagen	bəklaːɡən	2
beklagen	bəklaːɡn̩	2
bekommen	bəkɔmən	27
belassen	bəlasn̩	9
belassen	bəlasən	9
beleg	bəleːk	2
belgien	bɛlɡi̯ən	6
beliebig	bəliːbɪç	1
beliebt	bəliːpt	2
bellen	bɛlən	1
belohnung	bəloːnʊŋ	1
bemerkt	bəmɛrkt	1
bemerkung	bəmɛʁkʊŋ	2
bemühen	bəmyːən	1
benedikt	beːnədɪkt	2
benedikt	bɛnədɪkt	2
benedikt	beːnedɪkt	2
benehmen	bəneːmn̩	1
benehmen	bəneːmən	1
benehmen	bɛneːmɛn	1
benjamin	bɛnjamiːn	5
benjamin	-mɪn	5
benötigen	bənøːtɪɡən	8
beobachten	bəoːbaxtn̩	7
beobachten	bəʔoːbʔaxtən	7
beobachtung	bəʔoːbaxtʊŋ	1
bequem	bəkveːm	2
berater	bəʁaːtɐ	4
berechnen	bərɛçnən	1
bereich	bəʀaɪ̯ç	20
bereiten	bəʀaɪ̯tn̩	4
bereiten	bəʀaɪ̯tən	4
berg	bɛrk	9
berg	bɛɐ̯k	9
berg	b̥ɛrɡ̊	9
berg	bɛrç	9
berg	bɛɐ̯ç	9
berge	bɛʁɡə	2
berge	bɛɐ̯ɡə	2
bergen	bɛɐ̯ɡŋ̩	1
bergen	bɛɐ̯ɡən̪	1
bergung	bɛʁɡʊŋ	1
bericht	bəʀɪçt	18
berichten	bəʁɪçtən	13
berufen	bəʁuːfən	1
berufsverbot	bəruːfsfɛɐ̯boːt	3
berufung	bəʁuːfʊŋ	8
beruhigen	bəʁuːiɡən	6
beschäftigt	bəʃɛftɪkt	10
beschäftigt	bəʃɛftɪçt	10
bescheid	bəʃaɪt	2
bescheiden	bəʃaɪ̯dən	1
bescheidene	bəʃaɪ̯dənə	2
bescheidener	bəʃaɪ̯dənɐ	1
bescheidenheit	bəʃaɪ̯dənhaɪ̯t	1
beschimpfung	bəʃɪmpfʊŋ	1
beschleunigen	bəʃlɔynɪɡn	2
beschluss	bəʃlʊs	3
beschränken	bəʃʀɛŋkən	2
beschreiben	bəʃʀaɪ̯bm̩	1
beschreiben	bəʃʀaɪ̯bən	1
beschreibung	bəʃʁaɪ̯bʊŋ	5
beschuss	bəʃʊs	4
beschweren	bəʃveːʀən	1
beschwichtigen	bəʃvɪçtɪɡən	1
beseitigen	bəzaɪ̯tɪɡən	1
besetzen	bəzɛtsən	4
besiegen	bəziːɡən	2
besitz	bəzɪts	6
besitzen	bəzɪtsən	5
besitzer	bəzɪtsɐ	6
besorgt	bəzɔʁkt	5
besprechung	bəʃpʁɛçʊŋ	1
besser	bɛsɐ	58
besserung	bɛsəʀʊŋ	2
bestanden	bəʃtandən	1
bestanden	bəʃtandn̩	1
bestätigung	bəʃtɛːtiɡʊŋ	2
bestatter	bəʃtatɐ	1
bestattungen	bəʃtatʊŋən	2
bestaunen	bəʃtaʊ̯nən	1
bestechlichkeit	bəʃtɛçlɪçkaɪ̯t	1
bestechung	bəʃtɛçʊŋ	1
besteck	bəʃtɛk	1
bestehen	bəʃteːən	9
besteigen	bəʃtaɪ̯ɡən	1
bestellen	bəʃtɛlən	6
bestellung	bəʃtɛlʊŋ	2
besten	bɛstn̩	29
besten	bɛstən	29
bestenfalls	bɛstn̩fals	3
bestenfalls	bɛstənfals	3
bestimmen	bəʃtɪmən	5
bestrafen	bəʃtʁaːfən	1
bestsellerliste	bɛstzɛlɐlɪstə	1
besuch	bəzuːχ	9
besuchen	bəzuːxn̩	10
besuchen	bəzuːxən	10
betanken	bətaŋkŋ̩	1
betanken	bətaŋkən	1
betätigen	bətɛːtɪɡən	1
betätigung	bətɛːtɪɡʊŋ	1
beteiligen	bətaɪ̯lɪɡən	2
beteiligte	bətaɪ̯lɪçtə	1
beton	betɔŋ	1
beton	bətɔŋ	1
beton	betɔ̃ː	1
beton	bətɔ̃ː	1
beton	betoːn	1
betonen	bətoːnən	2
betracht	bətrɑxt	3
betrachten	bətʁaχtən	5
betrag	bətʁaːk	2
betrag	bətʁax	2
betrag	bətʁaːx	2
betrag	bətʀaːk	2
beträge	bətʀɛːɡə	2
betragen	bətʀaːɡŋ̩	4
betragen	bətʀaːɡən	4
betreiben	bətʁaɪ̯bən	4
betreiber	bətʀaɪ̯bɐ	3
betrieb	bətʁiːp	14
betrug	bətʁuːk	4
betrug	bətʁʊx	4
betrüger	bətʀyːɡɐ	3
betrunken	bətʀʊŋkŋ̩	1
betrunken	bətʀʊŋkən	1
betrunkener	bətʀʊŋkənɐ	1
bett	bɛt	2
bett	das‿bɛt	2
betten	bɛtn̩	2
bettina	bɛtiːna	2
beugen	bɔʏ̯ɡən	2
beute	bɔʏ̯tə	3
beutel	bɔʏ̯təl	3
bevölkerung	bəfœlkəʁʊŋ	19
bevor	bəfoːɐ̯	27
bevor	bəfɔɐ̯	27
bevorzugen	bəfoːɐ̯tsuːɡn	3
bewahren	bəvaːʁən	2
bewältigen	bəvɛltɪɡn̩	3
bewegen	bəveːɡən	11
bewegen	beveːʁen	11
bewegt	bəveːkt	7
bewegt	bəveːçt	7
bewegung	bəveːɡʊŋ	9
beweis	bəvaɪ̯s	2
beweisen	bəvaɪ̯zən	3
bewerber	bəvɛʁbɐ	8
bewerten	bəveːʁtən	3
bewertung	bəveːɐ̯tʊŋ	11
bewohner	bəvoːnɐ	4
bewusst	bəvʊst	12
bewusstsein	bəvʊstzaɪ̯n	1
bezahlen	bət͡saːlən	16
bezahlung	bət͡saːlʊŋ	5
bezeichnen	bətsaɪ̯çnən	1
bezeichnung	bətsaɪ̯çnʊŋ	1
beziehen	bətsiːən	5
beziehungsweise	bətsiːʊŋsvaɪ̯zə	8
bezirk	bət͡sɪʁk	2
bezug	bətsuːk	3
bezug	bətsux	3
bezug	bətsuːx	3
bezwingen	bət͡svɪŋən	1
bier	biːɐ̯	4
bieten	biːtən	26
bild	bɪlt	81
bilden	bɪldən	5
bildung	bɪldʊŋ	7
billigen	bɪlɪɡŋ̩	2
billigen	bɪlɪɡən	2
bin	bɪn	57
binde	bɪndə	1
binden	bɪndn̩	3
binden	bɪndən	3
binden	bɪndən	3
binden	bɪndn̩	3
binnen	bɪnən	5
bio	bio	2
biograf	bioɡʀaːf	1
biografie	bioɡʀafiː	2
biografien	bioɡʀafiːən	1
biologe	bioloːɡə	1
birgt	bɪʁkt	1
bis	bɪs	285
bischof	bɪʃɔf	2
bischof	bɪʃoːf	2
bisher	bɪsheːɐ̯	68
bislang	bɪslaŋ	28
bisschen	bɪsçən	14
bisschen	bɪskən	14
bisschen	bɪsjən	14
bisschen	bʏʃn	14
bisschen	bʏʒn	14
bissen	bɪsən	1
bist	bɪst	4
bit	bɪt	1
bitte	bɪtə	40
bitten	bɪtn̩	4
bitten	bɪtən	4
bitter	bɪtɐ	1
blamage	blamaːʒə	1
blatt	blat	2
blätter	blɛtɐ	1
blattläuse	blatlɔɪ̯zə	1
blau	blaʊ̯	1
blechdose	blɛçdoːzə	1
bleiben	blaɪ̯bən	35
blendend	blɛndənt	1
blick	blɪk	39
blicken	blɪkŋ̩	1
blicken	blɪkən	1
blind	blɪnt	1
blitz	blɪts	1
block	blɔk	2
blockbuster	blɔkbastɐ	3
blöd	bløːt	2
blog	blɔk	8
blondine	blɔndiːnə	1
bloss	bloːs	1
bludenz	bluːdɛnt͡s	1
blues	bluːs	2
blühen	blyːən	1
blühen	blyːən	1
blut	bluːt	9
blutlache	bluːtlaːxə	1
boden	boːdn̩	10
böden	bøːdn̩	1
böden	bøːdən	1
bohren	boːɐ̯n	1
bohren	boːʀən	1
boje	boːjə	1
bombardieren	bɔmbaʁdiːʁən	1
bombardierung	bɔmbaʁdiːʁʊŋ	1
bombe	bɔmbə	5
boni	boːni	2
bonn	bɔn	4
bonus	boːnʊs	3
boot	boːt	4
boote	boːtə	1
bord	bɔʁt	6
bordstein	bɔʁtʃtaɪ̯n	1
borg	bɔrk	1
born	bɔʁn	2
börse	bœrzə	9
börse	bœɐ̯zə	9
börsengang	bœʁzənɡaŋ	2
borussia	borʊsi̯a	1
böschung	bœʃʊŋ	1
böse	bøːzə	5
bösewicht	bøːzəvɪçt	1
boss	bɔs	2
botschafter	boːtʃaftɐ	3
box	bɔks	5
boxen	bɔksn̩	1
boxen	bɔksən	1
boxen	bɔksn̩	1
boxer	bɔksɐ	1
boykott	bɔɪkɔt	4
brach	bʀaːx	3
brachte	braxtə	10
brachte	braːxtə	10
branche	bʁãːʃə	6
branche	bʁɔ̃ːʃə	6
branche	bʁaŋʃə	6
branche	bʁɔŋʃə	6
branche	bʁãːʒə	6
branche	bʁɔ̃ːʒə	6
branche	bʁaŋʒə	6
branche	bʁɔŋʒə	6
brand	bʁant	6
brände	bʀɛndə	1
bratwurst	bʀaːtvʊʁst	1
brauch	bʀaʊ̯x	1
bräuche	bʀɔɪ̯çə	1
brauchen	braʊ̯xən	19
braun	bʁaʊ̯n	1
braun	braʊ̯n	1
braunschweig	bʁaʊ̯nʃvaɪ̯k	4
bräutigam	bʁɔʏtɪɡam	1
brautkleid	bʀaʊ̯tklaɪ̯t	1
brav	bʀaːf	1
brechen	bʁɛçən	1
breit	bʀaɪ̯t	4
breite	bʀaɪ̯tə	4
bremen	bʁeːmən	13
bremer	bʀeːmɐ	2
bremerhaven	bʁeːmɐhaːfən	1
bremsen	bʁɛmzən	2
bricht	bʁɪçt	4
brief	bʁiːf	4
brille	bʁɪlə	3
bringen	briŋən	26
brise	bʁiːzə	1
brite	bʁiːtə	3
brite	bʁɪtə	3
brocken	bʀɔkŋ̩	1
brocken	bʀɔkən	1
brot	bʁoːt	1
brötchen	bʁøːtçən	1
bruch	bʁʊx	2
bruch	bʁuːx	2
bruch	bʁʊx	2
brücke	bʁʏkə	2
bruder	bruːdɐ	5
brüder	bʀyːdɐ	4
brunnen	bʁʊnən	3
brüssel	bʀʏsl̩	27
brust	bʁʊst	2
brüste	bʀʏstə	1
brutal	bʀutaːl	3
brutaler	bʀutaːlɐ	1
brutalität	bʀutalitɛːt	1
bruttoinlandsprodukt	bʀʊtoʔɪnlantspʀodʊkt	1
buch	buːχ	7
buche	buːxə	1
buche	buːxə	1
buchen	buːxn̩	1
buchenwald	buːχn̩valt	1
bücher	byːçɐ	7
büchern	byːçɐn	2
buchladen	buːxlaːdn̩	1
buchladen	buːxlaːdən	1
budget	bydʒeː	3
buffet	bʏfeː	1
bug	buːk	1
bug	buːx	1
bühne	byːnə	13
bulgarien	bʊlɡaːʀi̯ən	4
bulle	bʊlə	1
bullen	bʊlən	1
bund	bʊnt	8
bundesliga	bʊndəsliːɡa	16
bundesrepublik	bʊndəsʀepubliːk	4
bundestag	bʊndəstaːk	4
bundeswehr	bʊndəsveːɐ̯	6
bündnis	bʏntnɪs	5
bunt	bʊnt	4
burg	bʊʁk	1
burg	bʊɐ̯ç	1
bürger	bʏʁɡɐ	11
bürger	bʏɐ̯ɡɐ	11
bürgermeister	bʏʁɡɐmaɪ̯stɐ	9
büro	byʀoː	5
bürokratie	byʀokʀatiː	1
büros	byʀoːs	2
bursche	bʊrʃə	1
bus	bʊs	2
busse	bʊsə	4
butler	batlɐ	2
c	tseː	7
cabrio	kaːbʁio	1
café	kafeː	1
campus	kampʊs	3
cds	tseːdeːs	1
cent	tsɛnt	6
chance	ʃãːsə	24
chance	ʃɔ̃ːsə	24
chance	ʃaŋsə	24
chance	ʃɔŋsə	24
chance	ʃaŋzə	24
chance	ʃɔŋzə	24
chaos	kaːɔs	5
charakter	karaktər	4
charakter	karaktɛr	4
charaktere	kaʁakteːʁə	4
charge	ʃaʁʒə	1
charge	ʃaːʒə	1
charge	ʃaʁʃə	1
charta	kaʁta	2
check	t͡ʃɛk	3
check	ʃɛk	3
chemie	çemiː	1
chemie	kemiː	1
chemie	ʃemiː	1
chemiker	çeːmikɐ	1
chemisch	çeːmɪʃ	1
chemisch	keːmɪʃ	1
chemisch	ʃeːmɪʃ	1
chemnitz	kɛmnɪts	3
chile	t͡ʃiːlə	2
chile	çiːlə	2
china	çiːna	22
china	ʃiːna	22
china	kiːna	22
chip	tʃɪp	4
chirurgie	çiʁʊɐɡiː	1
christoph	kʁɪstɔf	6
city	sɪti	15
claus	klaʊ̯s	2
club	klʊp	12
cluster	klastɐ	1
coach	koːtʃ	11
coach	kɔʊ̯tʃ	11
cola	koːla	1
colorado	kɔloʁaːdo	2
colorado	kɔləɹaːdo	2
comeback	kambɛk	6
comeback	kambɛk	6
community	kɔmjuːnɪti	3
computer	kɔmpjuːtɐ	11
containers	kɔnteːnɐs	1
containers	kɔntɛɪnɐs	1
cottbus	kɔtbʊs	3
couch	kaʊ̯tʃ	1
cousinen	kuziːnən	1
d	deː	5
da	daː	160
dabei	daˑbaɪ̯	138
dach	dax	3
dachfenster	daχfɛnstɐ	1
dafür	dafyːʁ	97
dagegen	daɡeːɡŋ̩	39
daheim	dahaɪ̯m	2
daher	daːheːɐ̯	34
dahin	dahɪn	10
dahinter	dahɪntəʁ	9
damaskus	damaskʊs	2
dame	daːmə	5
damit	damɪt	156
damit	daːmɪt	156
danach	danaːχ	30
däne	dɛːnə	1
dänemark	dɛːnəmaʁk	3
dänemark	deːnəmaʁk	3
daniel	daːniːɛl	13
daniel	daːni̯ɛl	13
daniel	daːnjəl	13
daniela	daːnjeːlɐ	4
dank	daŋk	23
dann	dan	252
daran	daran	33
darauf	daʀaʊ̯f	54
darauf	daːʀaʊ̯f	54
darin	daʀɪn	23
darin	daːʀɪn	23
darknet	daːɐ̯knɛt	2
darmstadt	daʁmʃtat	5
darstellen	daːʁʃtɛlən	3
darsteller	daːɐ̯ʃtɛlɐ	1
darstellung	daːɐ̯ʃtɛlʊŋ	4
darüber	daʁyːbɐ	35
das	das	2024
das	daːs	2024
dass	das	679
dat	dat	1
dat	dɐt	1
dat	dət	1
daten	daːtən	41
datenbanken	daːtn̩baŋkn̩	3
datenträger	daːtntʀɛːɡɐ	1
datum	daːtʊm	3
dauer	daʊ̯ɐ	4
dauerhaft	daʊ̯ɐhaft	3
dauern	daʊ̯ɐn	10
daumen	daʊ̯mən	3
david	daːvɪt	12
david	daːviːt	12
davon	dafɔn	72
dazu	datsuː	97
dazu	daːtsuː	97
deadline	dɛtlaɪ̯n	3
deckel	dɛkl̩	1
decken	dɛkən	5
deckung	dɛkʊŋ	2
defensiv	deːfɛnziːf	1
defensiv	deːfɛnziːf	1
defensiv	dɛfɛnziːf	1
defensiv	dɛfn̩ziːf	1
defensiv	dɛfɛnziːf	1
defensiv	dɛfn̩ziːf	1
definitiv	definitiːf	6
dein	daɪ̯n	2
deine	daɪ̯nə	5
deinem	daɪ̯nəm	1
deinem	daɪm	1
dekadent	dekadɛnt	1
dem	deːm	995
dem	dem	995
dem	dəm	995
demnach	deːmnaːx	12
demnach	deːmnaːx	12
demo	deːmo	4
demo	dɛmo	4
demo	deːmo	4
demokratie	demokʁatiː	9
demokratisch	demokʀaːtɪʃ	1
demonstrant	demɔnstʀant	1
den	deːn	1826
den	den	1826
den	dən	1826
denen	deːnən	63
denken	dɛŋkən	16
denkfabrik	dɛŋkfabʁiːk	1
denkmal	dɛŋkmaːl	1
denn	dɛn	98
depressiv	depʀɛsiːf	2
der	deːr	4992
derby	dɛʁbi	1
derby	dœʁbi	1
dereinst	deːɐ̯ʔaɪ̯nst	1
deren	deːʁən	33
derselbe	deːɐ̯zɛlbə	1
derselbe	dɛɐ̯zɛlbə	1
derzeit	deːɐ̯t͡saɪ̯t	76
des	dəs	840
des	dɛs	840
deshalb	dɛshalp	43
dessen	dɛsən	37
desto	dɛsto	9
deswegen	dɛsveːɡn̩	9
detail	detaɪ̯	5
deuten	dɔʏ̯tən	1
deutsch	dɔʏ̯tʃ	6
deutsch	dɔʏ̯t͡ʃ	6
dez	deːts	1
dezember	detsɛmbɐ	21
dezibel	deːtsibɛl	2
dialog	dialoːk	7
dich	dɪç	3
dicht	dɪçt	1
dichte	dɪçtə	1
dichten	dɪçtən	4
dichter	dɪçtɐ	2
dichter	dɪçtɐ	2
dick	dɪk	2
dicke	dɪkə	1
dicker	dɪkɐ	3
die	diː	5406
die	dɪ	5406
dieb	diːp	2
diebstahl	diːpʃtaːl	1
dienstag	diːnstaːk	45
dienstag	diːnstax	45
dienstag	diːnstaːx	45
dienstmädchen	diːnstmɛːtçən	1
diese	djese	252
dieser	diːzər	135
dieser	dɪzɐ	135
diffamieren	dɪfamiːʁən	1
differenzierbar	dɪfəʀɛntsiːɐ̯baːɐ̯	1
digital	diɡitaːl	7
diktatur	dɪktatuːɐ̯	1
ding	dɪŋ	2
ding	dɪŋk	2
dinge	dɪŋə	21
dingen	dɪŋən	3
dir	diːɐ̯	5
dir	dɐ	5
dir	də	5
direkt	diʁɛkt	29
direkt	dɪʁɛkt	29
direkt	dʁɛkt	29
direktor	diʀɛktoːɐ̯	3
direktorin	diʀɛktoːʀɪn	1
diskret	dɪskʁeːt	1
diskussion	dɪskʊsi̯oːn	8
diskutieren	dɪskutiːʀən	5
display	dɪsplɛɪ̯	7
display	dɪspleː	7
disziplin	dɪst͡sɪpliːn	1
doch	dɔx	199
doch	dɔ	199
doch	do	199
doktor	dɔktoːɐ̯	1
doktor	-tɔɐ̯	1
doktor	dɔktɐ	1
dokumentation	dokumentat͡si̯oːn	2
dollar	dɔlaʁ	53
dollar	dɔlɐ	53
dolmetscher	dɔlmɛt͡ʃɐ	1
dom	doːm	2
domain	domeɪ̯n	2
domäne	domeːnə	1
domäne	domɛːnə	1
dome	doːmə	1
dominanz	dominants	1
döner	døːnɐ	1
donner	dɔnɐ	1
donnerstag	dɔnɐstaːk	39
donnerstag	dɔnɐstax	39
donnerstag	dɔnɐstaːx	39
doof	doːf	1
doof	doːv-	1
doof	doːf-	1
doppelspitze	dɔpl̩ʃpɪt͡sə	1
doppelt	dɔpəlt	7
dorf	dɔrf	2
dorfbewohner	dɔʁfbəvoːnɐ	1
dörfer	dœʁfɐ	1
dort	dɔrt	79
dost	dɔst	2
dozenten	dot͡sɛntn̩	1
drachme	dʀaχmə	1
draht	dʁaːt	1
drängen	dʀɛŋən	6
dreharbeiten	dreːaʁbaɪtən	2
drehen	dʁeːən	6
dreher	dʁeːɐ	1
drei	dʁaɪ̯	142
dreien	dʁaɪ̯ən	1
dreifach	dʁaɪ̯faχ	1
dreihundert	dʁaɪ̯hʊndɐt	1
dreihundert	dʁaʊ̯nɐt	1
dreimal	draɪ̯maːl	2
dreissig	dʀaɪ̯sɪç	1
dreissig	dʀaɪ̯sɪç	1
dreist	draɪ̯st	1
dreiviertel	dʁaɪ̯fiːɐ̯tl̩	1
dresden	dʁeːsdən	7
drift	dʁɪft	1
drin	dʁɪn	2
drink	dʁɪŋk	1
drink	dɹɪŋk	1
dritte	drɪtə	17
drive	dʁaɪf	1
drohen	dʀoːən	5
dröhnen	dʁøːnən	1
drohung	dʁoːʊŋ	2
drosselung	dʁɔsəlʊŋ	1
druck	dʁʊk	30
dschungel	dʒʊŋəl	2
dschungel	tʃʊŋəl	2
du	duː	30
du	də	30
duell	duʔɛl	12
duisburg	dyːsbʊrk	4
duisburg	dyːsbʊrç	4
dumm	dʊm	3
dummchen	dʊmçən	1
dunkel	dʊŋkəl	1
dunkel	dʊŋkl̩	1
dunkeln	dʊŋkl̩n	1
dunkeln	dʊŋkəln	1
dünn	dʏn	2
durch	dʊʁç	244
durch	dʊɐ̯ç	244
durch	dʊɐ̯x	244
durch	dʊɪ̯ç	244
durchbrechen	dʊʁçbʁɛçən	1
durchbrechen	dʊʁçbʁɛçən	1
durcheinander	dʊʁçʔaɪnandɐ	3
durcheinander	dʊʁçʔaɪnandɐ	3
durcheinander	dʊʁçʔaɪ̯nandɐ	3
durchfahren	dʊʁçfaːʁən	1
durchringen	dʊʁçʁɪŋən	1
durchschnitt	dʊɐ̯çʃnɪt	5
durchschnitt	dʊɪ̯çʃnɪt	5
durchschnittlich	dʊɐ̯çʃnɪtlɪç	2
durchsetzen	dʊrçzɛtsən	2
durchsetzen	dʊrçzɛtsən	2
durchsuchen	dʊʁçzuːχən	2
durchsuchung	dʊʁçzuːχʊŋ	2
durchwühlen	dʊʁçvyːlən	1
dürfen	dʏrfən	38
dürfen	dʏrfən	38
dusche	duːʃə	4
dusche	dʊʃə	4
duschen	duːʃən	2
duschen	dʊʃən	2
duschen	duːʃn̩	2
düsseldorf	dʏsəldɔrf	10
düsseldorfer	dʏsl̩dɔʁfɐ	5
düsseldorfer	dʏsl̩dɔːvɐ	5
düster	dyːstər	1
dutt	dʊt	2
dutzend	dʊtsn̩t	5
dutzend	dʊtsənt	5
duzt	duːtst	1
dvd	deːfaʊ̯deː	1
dynamik	dynaːmɪk	3
dynamo	dynaːmo	2
dynamo	dyːnamo	2
dynamo	dʏnamo	2
e	ʔeː	2
eben	eːbən	27
ebene	ʔeːbənə	5
ebenfalls	eːbn̩fals	39
ebenso	eːbənzoː	26
echt	ɛçt	7
echtheit	ɛçthaɪ̯t	1
ecke	ɛkə	7
ecken	ʔɛkŋ̩	1
ecken	ʔɛkən	1
eckert	ɛkɐt	1
ecuador	eku̯adoːɐ̯	1
efeu	eːfɔʏ̯	1
effekt	ɛfɛkt	4
effektiv	ɛfɛktiːf	6
egal	eɡaːl	13
ehe	eːə	4
ehe	ʔeːə	4
ehemals	ʔeːəmaːls	3
eher	eːəʁ	41
ehre	eːʁə	3
ehren	eːʀən	1
ehren	eːʀən	1
ehrengast	eːʁənɡast	1
ehrenvoll	eːʁənfɔl	1
ehrlich	ʔeːɐ̯lɪç	5
ehrlichkeit	eːɐ̯lɪçkaɪt	1
ei	aɪ̯	1
eiche	aɪ̯çə	1
eidgenossenschaft	aitɡənɔsn̩ʃaft	1
eier	aɪ̯ɐ	1
eigen	aɪ̯ɡən	1
eigenheit	aɪ̯ɡənhaɪ̯t	1
eigeninteresse	aɪ̯ɡn̩ʔɪntəʁɛsə	1
eigens	aɪ̯ɡəns	1
eigenschaft	ʔaɪ̯ɡn̩ʃaːft	2
eigentlich	aɪ̯ɡəntlɪç	48
eigentlich	aɪ̯ŋklɪç	48
eigentlich	aɪ̯ntlɪç	48
eigentlich	aŋɪç	48
eigentum	aɪɡəntuːm	1
eigentümer	aɪ̯ɡəntyːmɐ	4
eilig	ʔaɪ̯lɪç	1
ein	aɪ̯n	1160
ein	ən	1160
ein	n̩	1160
einbauen	aɪ̯nbaʊ̯ən	1
einberufen	aɪ̯nbəʁuːfn̩	1
einbinden	aɪ̯nbɪndn̩	2
einbinden	aɪ̯nbɪndən	2
einblick	ʔaɪ̯nblɪk	4
einblicke	ʔaɪ̯nblɪkə	3
einbrecher	aɪ̯nbʀɛçɐ	1
einbruch	aɪ̯nbʁʊx	4
eindämmen	aɪ̯ndɛmən	1
eindringen	aɪ̯ndʀɪŋən	2
eine	ʔaɪ̯nə	1061
eines	aɪ̯nəs	141
einfach	ʔaɪ̯nfax	66
einfacher	ʔaɪ̯nfaxɐ	4
einfahren	ʔaɪ̯nfaːɐ̯n	1
einfahren	ʔaɪ̯nfaːʀən	1
einfallen	aɪ̯nfalən	1
einfangen	aɪ̯nfaŋən	1
einführung	aɪ̯nfyːʀʊŋ	5
eingabe	aɪ̯nɡaːbə	2
eingang	ʔaɪ̯nɡaŋ	1
eingeben	ʔaɪ̯nɡeːbm̩	2
eingeben	ʔaɪ̯nɡeːbən	2
eingehen	aɪ̯nɡeːən	1
eingreifen	aɪ̯nɡʁaɪ̯fən	1
eingriff	aɪ̯nɡʀɪf	3
einhaltung	aɪ̯nhaltʊŋ	7
einheit	aɪ̯nhaɪ̯t	2
einheiten	aɪ̯nhaɪ̯tən	7
einher	aɪ̯nheːɐ̯	3
einig	aɪ̯nɪç	5
einige	aɪ̯nɪɡə	63
einkaufen	aɪ̯nkaʊ̯fən	2
einkaufswagen	aɪ̯nkaʊ̯fsvaːɡən	1
einkaufszentrum	aɪ̯nkaʊ̯fst͡sɛntʁʊm	2
einkehr	aɪ̯nkeːɐ̯	1
einklang	aɪ̯nklaŋ	1
einkommen	aɪ̯nkɔmən	9
einkommen	aɪ̯nkɔmən	9
einladen	aɪ̯nlaːdən	1
einlegen	aɪ̯nleːɡən	1
einmal	aɪ̯nmaːl	75
einmarschieren	ʔaɪ̯nmaʁʃiːʁən	1
einmischung	aɪnmɪʃʊŋ	1
einnehmen	ʔaɪ̯nneːmən	1
einreichen	aɪ̯nʁaɪ̯çən	1
einrichten	ʔaɪ̯nʀɪçtn̩	4
einrichten	ʔaɪ̯nʀɪçtən	4
einrichtung	ʔaɪ̯nʀɪçtʊŋ	4
einsatz	ʔaɪ̯nzats	30
einschätzen	aɪ̯nʃɛtsən	3
einschätzung	aɪ̯nʃɛtsʊŋ	7
einschlafen	ʔaɪ̯nʃlaːfɱ̩	1
einschlafen	ʔaɪ̯nʃlaːfən	1
einsetzbar	ʔaɪ̯nzɛtsbaːɐ̯	1
einsetzen	ʔaɪ̯nzɛtsn̩	9
einsetzen	ʔaɪ̯nzɛtsən	9
einsicht	aɪ̯nzɪçt	1
einsteigen	ʔaɪ̯nʃtaɪ̯ɡŋ̩	3
einsteigen	ʔaɪ̯nʃtaɪ̯ɡən	3
einstellung	aɪ̯nʃtɛlʊŋ	3
einstieg	aɪ̯nʃtiːk	5
einstimmig	aɪ̯nʃtɪmɪç	1
eintracht	aɪ̯ntʁaxt	11
eintragen	aɪ̯ntʁaːɡən	1
eintreiben	aɪ̯ntʁaɪ̯bn̩	2
eintritt	aɪ̯ntrɪt	5
einverstanden	aɪ̯nfɛɐ̯ʃtandn̩	3
einwanderer	ʔaɪ̯nvandəʁɐ	5
einwohner	aɪ̯nvoːnɐ	3
einwohnern	ʔaɪ̯nvoːnɐn	1
einzelhandel	aintsəlhandəl	2
einzelheiten	aɪ̯ntsl̩haɪ̯tn̩	4
einziehen	aɪ̯nt͡siːə̯n	2
einzig	aɪ̯nt͡sɪç	4
einzig	aɪ̯nt͡sɪɡ̊	4
einzigartig	aɪ̯nt͡sɪçʔaːɐ̯tɪç	2
einziger	ʔaɪntsɪɡɐ	3
einzug	aɪntsuːk	3
einzug	aɪ̯ntsʊx	3
eis	aɪ̯s	4
eis	ʔeːɪs	4
eis	ʔaɪ̯s	4
eisberg	ʔaɪ̯sbɛʁk	1
eisberg	ʔaɪ̯sbɛɐ̯k	1
eisbergs	ʔaɪ̯sbɛʁks	1
eisbergs	ʔaɪ̯sbɛɐ̯ks	1
eisen	ʔaɪ̯zn̩	2
eisen	ʔaɪ̯zən	2
eisen	aɪ̯zən	2
eisenbahn	aɪ̯zənbaːn	1
eishockey	ʔai̯shɔkeː	2
eishockey	ʔai̯shɔki	2
eishockeys	ʔai̯shɔkeːs	1
eishockeys	ʔai̯shɔkis	1
eiskalt	aɪ̯skalt	1
eiskalt	aɪ̯skalt	1
eiskalt	aɪ̯skalt	1
eklig	eːklɪç	1
elefant	elefant	2
elefanten	elefantn̩	2
elektrizität	elɛktʀitsitɛːt	1
elektronisch	elɛktʀoːnɪʃ	2
element	elemɛnt	1
elend	eːlɛnt	2
elf	ʔɛlf	12
elf	ʔɛlf	12
elfenbeinküste	ɛlfənbaɪ̯nkʏstə	3
elisabeth	ʔeliːzabɛt	1
eltern	ɛltɐn	22
email	emaɪ̯	2
email	iːmɛɪ̯l	2
email	iːmeːl	2
empfangen	ɛmpfaŋən	2
empfänger	ɛmpfɛŋɐ	5
empfehlen	ʔɛmpfeːlən	14
empfehlung	ɛmpfeːlʊŋ	5
empfehlungen	ɛmpfeːlʊŋən	3
empfinden	ɛmpfɪndn̩	2
empört	ɛmpøːɐ̯t	1
empörung	ɛmpøːʀʊŋ	4
ende	ɛndə	100
enden	ɛndən	1
endlich	ɛntlɪç	22
energie	eːnɛʁɡiː	12
energisch	eːnɛʁɡɪʃ	2
eng	ɛŋ	6
engagement	ãɡaʒmãː	9
engagieren	ɑ̃ɡaʒiːʁən	2
engel	ɛŋl̩	2
engen	ɛŋən	3
england	ɛŋlant	11
engländer	ɛŋlɛndɐ	4
engländerin	ɛŋlɛndəʁɪn	1
englisch	ɛŋlɪʃ	4
englisch	ɛŋlɪʃ	4
enorm	enɔʁm	5
entdecken	ɛntdɛkən	10
enteignung	ɛntʔaɪ̯ɡnʊŋ	1
entfernen	ɛntfɛʁnən	2
entfremdung	ɛntfʀɛmdʊŋ	1
entgehen	ɛntɡeːən	1
enthüllung	ɛnthʏlʊŋ	1
entlang	ɛntlaŋ	2
entlassen	ɛntlasn̩	6
entlehnen	ɛntleːnən	1
entpuppen	ɛntpʊpn̩	1
entrichten	ʔɛntʀɪçtn̩	1
entrichten	ʔɛntʀɪçtən	1
entschädigung	ʔɛntʃɛːdɪɡʊŋ	2
entscheiden	ʔɛntʃaɪ̯dn̩	16
entscheiden	ʔɛntʃaɪ̯dən	16
entscheidend	ʔɛntʃaɪ̯dn̩t	6
entscheidend	ʔɛntʃaɪ̯dənt	6
entscheidung	ʔɛntʃaɪ̯dʊŋ	35
entscheidungen	ʔɛntʃaɪ̯dʊŋən	2
entschieden	ʔɛntʃiːdn̩	16
entschieden	ʔɛntʃiːdən	16
entschlüsseln	ʔɛntʃlʏsl̩n	2
entschlüsseln	ʔɛntʃlʏsəln	2
entschuldigen	ɛntʃʊldiɡən	1
entschuldigung	ɛntʃʊldiɡʊŋ	1
entsetzen	ɛntzɛtsən	1
entsetzen	ɛntsɛtsən	1
entspannen	ʔɛntʃpanən	2
entspannung	ʔɛntʃpanʊŋ	3
entstehen	ʔɛntʃteːən	10
enttäuschen	ɛnttɔɪ̯ʃn	1
enttäuscht	ɛntɔɪ̯ʃt	8
entweder	ɛntveːdɐ	13
entwenden	ʔɛntvɛndn̩	1
entwenden	ʔɛntvɛndən	1
entwickeln	ʔɛntvɪkl̩n	9
entwickeln	ʔɛntvɪkəln	9
entwurf	ɛntvʊʁf	5
entzug	ʔɛnttsuːk	2
entzug	ʔɛnttsux	2
entzug	ʔɛnttsuːx	2
er	ʔeːɐ̯	622
er	ʔɛʁ	622
er	ɐ	622
er	eːɐ̯	622
erachten	ɛɐ̯ʔaχtn̩	1
erachten	ɛɐ̯ʔaχtn̩	1
erdbeben	eːɐ̯tbeːbn̩	2
erde	eːɐ̯də	9
erde	ɛʁdə	9
erden	eːɐ̯dn	1
erdkreis	eːɐ̯tkʁaɪ̯s	1
ereignisse	ɛɐ̯ʔaɪ̯ɡnɪsə	7
ereignissen	ɛɐ̯ʔaɪ̯ɡnɪsən	3
erfahren	ʔɛɐ̯faːɐ̯n	10
erfahren	ʔɛɐ̯faːʀən	10
erfahrung	ɛɐ̯faːʀʊŋ	16
erfinden	ɛʁfɪndən	1
erfinder	ɛɐ̯fɪndɐ	1
erfolg	ɛʁfɔlk	20
erforderlich	ɛɐ̯fɔʁdɐlɪç	6
erforschung	ɛɐ̯fɔʁʃʊŋ	1
erfreuen	ɛʁfʁɔʏ̯ən	1
erfüllen	ʔɛɐ̯fʏlən	11
ergab	ɛʀɡaːp	2
ergeben	ɛʀɡeːbən	5
ergebnisse	ɛɐ̯ɡeːpnɪsə	21
ergo	ɛʁɡo	1
ergreifen	ɛʁɡʁaɪfən	3
ergüsse	ɛɐ̯ɡʏsə	1
erhaben	ɛrhaːbən	1
erhalten	ɛʁhaltən	36
erhaltung	ɛɐ̯haltʊŋ	3
erhöhen	ɛɐ̯høːən	7
erhöhung	ɛɐ̯høːʊŋ	4
erinnerung	ɛɐʔɪnəʁʊŋ	1
erinnerung	ɛɐʁɪnəʁʊŋ	1
eritrea	eʁitʁeːa	3
erkennen	ɛɐ̯kɛnən	21
erkenntnis	ɛɐ̯kɛntnɪs	4
erklären	ɛɐ̯klɛːʁən	12
erkrankung	ʔɛɐ̯kʀaŋkʊŋ	2
erlangen	ɛɐ̯laŋən	2
erlassen	ʔɛɐ̯lasn̩	2
erlassen	ʔɛɐ̯lasən	2
erlaubnis	ɛɐ̯laʊ̯pnɪs	1
erläutern	ɛʁlɔʏ̯təʁn	2
erleben	ʔɛɐ̯leːbm̩	10
erleben	ʔɛɐ̯leːbən	10
erlebnis	ʔɛɐ̯leːbnɪs	4
erleichtern	ʔɛɐ̯laɪ̯çtɐn	2
ermittler	ɛɐ̯mɪtlɐ	10
ermittlung	ɛɐ̯mɪtlʊŋ	1
ermordung	ɛɐ̯mɔʁdʊŋ	2
ermutigen	ɛʁmuːtiɡən	2
ernähren	ʔɛɐ̯nɛːɐ̯n	3
ernähren	ʔɛɐ̯nɛːʀən	3
ernennung	ʔɛɐ̯nɛnʊŋ	3
erneuern	ʔɛɐ̯nɔɪ̯ɐn	1
erneut	ɛʁnɔɪ̯t	26
ernst	ɛʁnst	12
ernst	ɛʁnst	12
ernsthaft	ɛʁnsthaft	3
ernten	eɐ̯ntn̩	2
eröffnen	ʔɛɐ̯ʔœfnən	3
erregung	ɛʁeːɡʊŋ	1
erreichen	ɛɐ̯ʁaɪ̯çən	19
errichten	ɛʁɪçtən	2
ersatz	ʔɛɐ̯zats	3
ersatzfahrplan	ʔɛɐ̯zat͡sfaːɐ̯plaːn	1
erschaffen	ɛʁʃafən	2
erscheinen	ɛɐ̯ʃaɪ̯nən	9
erscheinung	ɛɐ̯ʃaɪ̯nʊŋ	1
erschöpfung	ɛɐ̯ʃœpfʊŋ	1
erschrecken	ɛʁʃʁɛkən	1
ersetzen	ʔɛɐ̯zɛtsn̩	7
ersetzen	ʔɛɐ̯zɛtsən	7
erste	eːɐ̯stə	68
erstellen	ɛʁʃtɛlən	5
ersten	ʔɛɐ̯stn̩	129
ersten	ʔɛɐ̯stən	129
ertragen	ɛʁtʁaːɡən	2
ertrinken	ʔɛɐ̯tʀɪŋkŋ̩	1
ertrinken	ʔɛɐ̯tʀɪŋkən	1
erwachsene	ɛɐ̯vaksənə	3
erwägung	ɛɐ̯vɛːɡʊŋ	1
erwarten	ɛɐ̯vaʁtən	16
erweitern	ʔɛɐ̯vaɪ̯tɐn	3
erwerben	ɛɐ̯vɛʁbən	3
erwidern	ʔɛɐ̯viːdɐn	1
erzählen	ɛɐ̯t͡sɛːlən	3
erzählerin	ɛʁtsɛːləʁɪn	1
erzählung	ɛɐtsɛːlʊŋ	1
erzeuger	ɛɐ̯t͡sɔɪ̯ɡɐ	1
erzeugung	ɛɐ̯tsɔʏ̯ɡʊŋ	1
erzfeind	ɛɐ̯t͡sfaɪ̯nt	1
erzieher	ɛɐ̯t͡siːɐ	4
erziehung	ɛɐ̯tsiːʊŋ	1
erzielen	ɛɐ̯tsiːlən	3
es	ɛs	1158
eskalation	ɛskalat͡si̯oːn	1
essen	ɛsən	8
esslöffel	ɛslœfəl	1
etablieren	etabliːʁən	4
etage	etaːʒə	2
etage	etaːʃ	2
etappe	etapə	5
etat	etaː	1
etikette	etikɛtə	1
etwas	ɛtvas	84
euer	ɔʏ̯ɐ	3
euphorie	ɔɪ̯foʀiː	2
euro	ɔʏ̯ʁoː	230
europa	ɔʏ̯ʁoːpa	64
europäer	ɔɪ̯ʀopɛːɐ	5
eva	eːfa	1
evolution	ʔevolutsi̯oːn	1
ewig	eːvɪç	3
ex	ʔɛks	2
exekutive	ɛksekutiːvə	1
experiment	ɛkspeʀimɛnt	2
experte	ɛkspɛʁtə	6
explizit	ɛksplitsɪt	1
expressiv	ɛkspʀɛsiːf	1
extra	ɛkstʁa	7
extrem	ɛkstʁeːm	11
exzellent	ɛkstsɛlɛnt	2
exzellent	ɛksəlɛnt	2
fabian	faːbian	4
fabrik	fabʀiːk	1
fabrik	fabʀɪk	1
fabriken	fabʀiːkn̩	3
facebook	fɛɪ̯sbʊk	31
facebook	feːs-	31
facebooks	feːsbʊks	1
fach	fax	1
fach	faχ	1
fächer	fɛçɐ	1
fad	faːt	1
fahnder	faːndɐ	1
fahndung	faːndʊŋ	2
fahren	faːʁən	30
fahren	faːn	30
fahrer	faːʁɐ	11
fahrerin	faːʀəʁɪn	1
fahrrad	faːɐ̯ʁaːt	1
fahrrad	faʁat	1
fahrräder	faːɐ̯ʀɛːdɐ	1
fahrt	faːɐ̯t	9
fahrt	faːt	9
fahrt	faːʀt	9
fährt	fɛːɐ̯t	9
fährt	fɛːrt	9
fahrten	faːɐ̯tn̩	3
fahrten	faːɐ̯tən	3
fahrzeug	faːɐ̯tsɔʏ̯k	12
fahrzeug	faːtsɔʏ̯ç	12
fahrzeuge	faːɐ̯t͡sɔɪ̯ɡə	5
fair	fɛːr	5
fall	fal	61
fall	fal	61
falle	falə	5
falle	falə	5
fälle	fɛlə	7
fälle	fɛlə	7
fallen	faln̩	16
fallen	falən	16
fallen	falən	16
fällen	fɛlən	5
fällen	fɛlən	5
fallout	fɔːlʔaʊ̯t	6
falls	fals	11
fallschirm	falʃɪʁm	1
fällt	fɛlt	18
falsch	falʃ	14
fälschen	fɛlʃən	1
fälschlicherweise	fɛlʃlɪçɐvaɪ̯zə	2
familie	famiːliə	26
fand	fant	20
fände	fɛndə	1
fanden	fandn̩	8
fanden	fandən	8
fangen	faŋən	2
farbe	faʁbə	5
farbe	faːbə	5
farbgebung	faʁpɡeːbʊŋ	1
fasching	faʃɪŋ	1
fass	fas	1
fassen	fasn̩	6
fassen	fasən	6
fässer	fɛsɐ	1
fasst	fast	4
fassung	fasʊŋ	2
fast	fast	64
fast	faːst	64
faszinieren	fastsiniːrən	1
faulen	faʊ̯lən	2
favorit	favoʁiːt	6
favorit	favoʁɪt	6
fazit	faːt͡sit	9
februar	feːbruaːr	26
feder	feːdəʁ	1
feedback	fiːdbɛk	2
fehlen	feːlən	8
fehler	feːlɐ	35
feier	fa̯ɪɐ	2
feiern	faɪ̯ɐn	5
feiertag	faɪɐ̯taːk	1
feiertag	faɪɐ̯tax	1
feiertag	faɪɐ̯taːx	1
fein	faɪ̯n	1
feind	faɪ̯nt	4
feld	fɛlt	7
felder	fɛldɐ	1
feldes	fɛldəs	2
fell	fɛl	2
feminismus	feːminɪsmʊs	2
feminismus	fɛmɪnɪsmʊs	2
fenster	fɛnstɐ	5
fensterscheibe	fɛnstɐʃaɪ̯bə	1
ferne	fɛʀnə	6
fernsehen	fɛʁnzeːən	9
fernsehen	fɛʁnzeːn	9
fernsehen	fɛʁnzeːən	9
fernsehen	fɛʁnzeːn	9
fernseher	fɛʁnzeːɐ	6
fertig	fɛrtɪç	9
fertig	fɛːdɪç	9
fertig	fɛrtiɡ	9
fest	fɛst	23
fest	fɛst	23
feste	fɛstə	1
feste	fɛstə	1
festland	fɛstlant	1
festlegen	fɛstleːɡən	2
feststellen	fɛstʃtɛlən	3
feststellung	fɛstʃtɛlʊŋ	2
festung	fɛstʊŋ	2
fett	fɛt	1
fett	fɛt	1
fetten	fɛtən	1
feuer	fɔʏər	12
feuer	faɪər	12
feuerwehr	fɔɪ̯ɐveːɐ̯	11
feuerwehrmann	fɔʏɐveːɐman	2
fichte	fɪçtə	1
fiel	fiːl	18
fielen	fiːlən	4
figur	fiɡuːɐ̯	10
filiale	fili̯aːlə	1
filtern	fɪltɐn	1
final	finaːl	4
final	finaːl	4
finale	finaːlə	14
finanzamt	finantsʔamt	1
finanziell	finant͡si̯ɛl	4
finanzieren	finantsiːɐ̯n	8
finanzieren	finantsiːʀən	8
finde	fɪndə	10
findest	fɪndəst	1
findet	fɪndət	29
finger	fɪŋɐ	4
fingerfertigkeit	fɪŋɐfɛʁtɪçkaɪ̯t	1
fink	fɪŋk	2
firma	fɪrma	18
first	fɪʁst	3
fisch	fɪʃ	4
fischen	fɪʃən	1
fischer	fɪʃɐ	8
fitnessstudio	fɪtnəsʃtuːdio	1
fitnessstudio	-ʃtuːdjo	1
fixieren	fɪksiːɐ̯n	1
fixieren	fɪksiːʀən	1
fläche	flɛçə	1
flagge	flaɡə	1
flaggen	flaɡŋ̩	1
flaggen	flaɡən	1
flaschen	flaʃn̩	1
flaschen	flaʃən	1
fleck	flɛk	2
fledermaus	fleːdɐmaʊ̯s	1
fleisch	flaɪ̯ʃ	3
flexibilität	flɛksibilitɛːt	2
fliege	fliːɡə	1
fliegen	fliːɡŋ̩	9
fliegen	fliːɡən	9
fliegen	fliːɡn	9
fliegen	fliːɡən	9
flieger	fliːɡɐ	3
fliegt	fliːkt	6
fliegt	fliːçt	6
fliehen	fliːən	3
fliessen	fliːsn̩	1
fliessen	fliːsən	1
flog	floːk	3
floh	floː	1
flop	flɔp	1
florenz	floʀɛnts	1
florian	floːʁi̯aːn	10
florida	flɔʁida	2
florida	flɔɹədɐ	2
floss	flɔs	2
floss	floːs	2
fluch	fluːx	1
fluchen	fluːxn̩	1
flucht	flʊxt	13
flüchten	flʏçtən	2
flüchtig	flʏçtɪç	1
flug	fluːk	4
flug	flux	4
flug	fluːx	4
flugbegleiter	fluːkbəɡlaɪ̯tɐ	1
flugblatt	fluːkblat	1
flüge	flyːɡə	5
flügel	flyːɡl̩	3
flügel	flyːɡəl	3
flughafen	fluːkhaːfɱ̩	6
flughafen	fluːkhaːfən	6
flughäfen	fluːkhɛːfɱ̩	3
flughäfen	fluːkhɛːfən	3
flugs	fluks	1
flugzeug	fluːktsɔʏ̯k	5
flugzeuge	fluːktsɔɪ̯ɡə	6
flugzeuges	fluːktsɔɪ̯ɡəs	1
flugzeugs	fluːktsɔɪ̯ks	1
flugzeugträgers	fluːktsɔɪ̯ktʀɛːɡɐs	1
fluss	flʊs	3
flüsse	flʏsə	1
flut	fluːt	1
fohlen	foːlən	1
fokus	foːkʊs	14
folge	fɔlɡə	27
folgen	fɔlɡŋ̩	32
folgen	fɔlɡən	32
folgen	fɔlɡŋ̩	32
folgen	fɔlɡən	32
folgerichtig	fɔlɡəʀɪçtɪç	1
folklore	fɔlkloːʁə	1
folter	fɔltɐ	2
fonds	fõː	13
fonds	fõːs	13
fordern	fɔʁdəʁn	9
fördern	fœʁdɐn	3
forderung	fɔʁdəʁʊŋ	3
förderung	fœʁdəʀʊŋ	7
formen	fɔʁmən	2
forscher	fɔʁʃɐ	10
forschung	fɔʁʃʊŋ	7
forst	fɔʁst	1
fortschritt	fɔʁtʃʀɪt	2
fortsetzung	fɔʁtzɛt͡sʊŋ	1
forum	foːʁʊm	3
foto	foːto	58
foul	faʊ̯l	1
fracht	fraxt	2
frage	fʀaːɡə	41
frage	fʀaːɡə	41
fragen	fʁaːɡən	43
fragezeichen	fʀaːɡətsaɪ̯çn̩	2
fraglich	fʀaːklɪç	5
fragt	fʁaːkt	5
fragt	fʁaːxt	5
frank	fʁaŋk	14
franken	fʀaŋkən	37
franken	fʀaŋkən	37
franken	fʀaŋkən	37
frankfurter	fʀaŋkfʊʁtɐ	7
frankreich	fʁaŋkʁaɪ̯ç	23
franziskus	fʁantsɪskʊs	4
franzose	fʀantsoːzə	3
frau	fʁaʊ̯	53
frau	fraʊ̯	53
frauen	fʀaʊən	34
fräulein	fʁɔʏ̯laɪ̯n	1
fräulein	fʁɔlaɪ̯n	1
frei	fraɪ̯	16
freiburger	fʀaɪ̯bʊʁɡɐ	2
freien	fʁaɪ̯ən	9
freier	fʀaɪ̯ɐ	3
freier	fʁaɪ̯ɐ	3
freiheit	fʀaɪ̯haɪ̯t	7
freiheiten	fʀaɪ̯haɪ̯tn̩	2
freiheiten	fʀaɪ̯haɪ̯tən	2
freisetzen	fʁaɪ̯zɛtsən	1
freispruch	fʁaɪ̯ʃpʁʊx	2
freitag	fʀaɪ̯taːk	50
freitag	fʀaɪ̯tax	50
freitag	fʀaɪ̯taːx	50
freiwillig	fʀaɪ̯vɪlɪç	2
fremd	fʁɛmt	2
fremde	fʀɛmdə	1
freude	fʀɔʏ̯də	6
freuen	fʀɔɪ̯ən	13
freund	frɔʏ̯nt	8
freundin	fʁɔʏ̯ndɪn	3
freundlich	fʀɔɪ̯ntlɪç	2
freundlicher	fʀɔɪ̯ntlɪçɐ	1
freundschaft	fʀɔɪ̯ntʃaft	1
frieden	friːdən	3
friederich	fʁiːdəʁɪç	1
friederich	fʁɪdəʁɪç	1
friederich	fʁiːdʁɪç	1
friederich	fʁɪdʁɪç	1
friedhof	fʀiːthoːf	2
friedlich	fʁiːtlɪç	2
friedrich	fʁiːdʁɪç	3
friedrich	fʁɪdʁɪç	3
friedrich	fʁiːdəʁɪç	3
friedrich	fʁɪdəʁɪç	3
frisch	fʀɪʃ	4
froh	fʁoː	10
front	fʀɔnt	4
frontlinie	fʁɔntliːni̯ə	1
frucht	fʁʊxt	1
früchte	fʀʏçtə	1
früh	fryː	9
früh	fʁyː	9
frühe	fryːə	1
früher	fryːɐ	18
frühling	fʀyːlɪŋ	3
fucking	fʊkɪŋ	1
fühlen	fyːlən	4
fühler	fyːlɐ	2
führe	fyːʀə	4
führen	fyːʁən	24
führen	fyːɐ̯n	24
führen	fʏɐ̯n	24
führer	fyːrər	1
führer	fyːrɐ	1
führerschein	fyːrərʃaɪ̯n	1
führung	fyːʀʊŋ	22
fülle	fʏlə	1
füllen	fʏlən	4
füllen	fʏlən	4
fund	fʊnt	2
fundamental	fʊndamɛntaːl	1
fündig	fʏndiç	1
fundus	fʊndʊs	1
fünf	fʏnf	54
fünf	fʏmf	54
fünfmal	fʏnfmaːl	1
fünfte	fʏnftə	5
fungieren	fʊŋɡiːʁən	1
funk	faŋk	2
funk	fʊŋk	2
funken	fʊŋkŋ̩	1
funken	fʊŋkən	1
funktionieren	fʊŋktsjoniːrən	4
für	fyːr	1351
für	fyːɐ̯	1351
für	fʏɐ̯	1351
für	fə	1351
furcht	fʊʁçt	4
fürchten	fʏʁçtən	3
fuss	fuːs	3
fussball	fuːsbal	2
fusse	fuːsə	1
füsse	fyːsə	1
füsse	fyːsə	1
füssen	fʏsn̩	1
futter	fʊtɐ	1
füttern	fʏtɐn	1
g	ɡeː	4
gab	ɡaːp	75
gäbe	ɡɛːbə	5
gaben	ɡaːbm̩	4
gaben	ɡaːbən	4
gäben	ɡɛːbm̩	1
gäben	ɡɛːbən	1
gähnen	ɡeːnən	1
gähnen	ɡɛːnən	1
gala	ɡaːla	3
galgen	ɡalɡən	1
gang	ɡaŋk	6
gang	ɡɛŋ	6
ganz	ɡants	77
ganze	ɡantsə	24
ganze	ɡantsə	24
ganzes	ɡantsəs	2
gar	ɡaːɐ̯	56
gar	ɡaː	56
garage	ɡaʁaːʒə	2
garage	ɡaʁaːʃə	2
garantie	ɡaʁantiː	3
garderobe	ɡaʁdəʁoːbə	1
garderobe	ɡɐdʁoːbə	1
garn	ɡaʁn	1
garten	ɡaʁtən	6
gärtnerei	ɡɛrtnəraɪ̯	1
gas	ɡaːs	3
gas	ɡas	3
gäste	ɡɛstə	14
gastgeber	ɡastɡeːbɐ	6
gattung	ɡatʊŋ	1
gaul	ɡaʊl	1
gebäude	ɡəbɔʏ̯də	15
gebe	ɡeːbə	20
gebeten	ɡəbeːtən	3
gebeten	ɡəbeːtn̩	3
gebiet	ɡəbiːt	6
geboren	ɡəboːrən	7
gebrauch	ɡəbʁaʊ̯x	2
gebühr	ɡəbyːɐ̯	1
gebunden	ɡəbʊndn̩	3
gebunden	ɡəbʊndən	3
geburt	ɡəbuːɐ̯t	5
geburtsort	ɡəbuːɐ̯t͡sʔɔʁt	1
geburtstag	ɡəbuːɐ̯t͡staːk	3
gedächtnis	ɡədɛçtnɪs	2
gedanke	ɡədaŋkə	1
gedanken	ɡədaŋkən	12
gedenken	ɡədɛŋkŋ̩	1
gedenken	ɡədɛŋkən	1
gedöns	ɡədøːns	1
geduld	ɡədʊlt	4
geduldig	ɡədʊldɪç	1
geendet	ɡəʔɛndət	1
gefahr	ɡəfaːɐ̯	14
gefährden	ɡəfɛːɐ̯dn̩	1
gefährdung	ɡəfɛːɐ̯dʊŋ	1
gefährlich	ɡəfɛːɐ̯lɪç	7
gefallen	ɡəfaln̩	8
gefallen	ɡəfalən	8
gefallen	ɡəfalən	8
gefällt	ɡəfɛlt	10
gefälscht	ɡəfɛlʃt	1
gefängnis	ɡəfɛŋnɪs	6
gefängnisse	ɡəfɛŋnɪsə	1
geflügel	ɡəflyːɡəl	1
gefragt	ɡəfʀaːkt	12
gefühl	ɡəfyːl	14
gefühle	ɡəfyːlə	3
gefunden	ɡəfʊndən	31
gegeben	ɡəɡeːbn̩	33
gegeben	ɡəɡeːbən	33
gegen	ɡeɡən	339
gegenargument	ɡeːɡn̩ʔaʁɡumɛnt	1
gegend	ɡeːɡənt	2
gegenmittel	ɡeːɡn̩mɪtl̩	1
gegensatz	ɡeːɡn̩zats	1
gegenteil	ɡeːɡn̩taɪ̯l	12
gegenüber	ɡeːɡn̩ʔyːbɐ	55
gegenwart	ɡeːɡn̩vaʁt	3
gegenwärtig	ɡeːɡənvɛʁtɪç	2
gegenzug	ɡeːɡŋ̩tsuːk	2
gegenzug	ɡeːɡəntsuːk	2
gegner	ɡeːɡnɐ	14
gegner	ɡeːknɐ	14
gegner	ɡeːçnɐ	14
gegründet	ɡəɡʁʏndət	5
gehabt	ɡəhaːpt	9
gehabt	ɡəhabd	9
gehälter	ɡəhɛltɐ	3
gehäuse	ɡəhɔɪ̯zə	4
gehege	ɡəheːɡə	1
geheim	ɡəhaɪ̯m	4
geheimdienst	ɡəhaɪ̯mdiːnst	2
geheimnis	ɡəhaɪmnɪs	4
gehen	ɡeːən	60
gehen	ɡeːn	60
gehirn	ɡəhɪʁn	2
gehör	ɡəhøːɐ̯	2
gehören	ɡəhøːʁən	13
gehören	ɡəhøːɐ̯n	13
gehört	ɡəhøːɐ̯t	32
gehweg	ɡeːveːk	1
geier	ɡaɪ̯ɐ	1
geist	ɡaɪ̯st	2
geisterbahn	ɡaɪ̯stɐbaːn	1
geizig	ɡaɪ̯tsɪç	1
gekocht	ɡəkɔχt	2
gekonnt	ɡəkɔnt	1
gelände	ɡəlɛndə	5
gelassen	ɡəlasn̩	8
gelb	ɡɛlp	3
gelb	ɡɛlp	3
geld	ɡɛlt	68
geldanlage	ɡɛltʔanlaːɡə	1
gelder	ɡɛldɐ	1
geldes	ɡɛldəs	2
geldstrafe	ɡɛltʃtʁaːfə	2
gelegentlich	ɡəleːɡəntlɪç	2
geleitet	ɡəlaɪ̯tət	1
gelenk	ɡəlɛŋk	1
gelesen	ɡəleːzən	6
gelöst	ɡəløːst	4
gelsenkirchen	ɡɛlzənkɪʁçən	1
gelten	ɡɛltn̩	13
gelten	ɡɛltən	13
gelungen	ɡəlʊŋən	12
gemacht	ɡəmaxt	45
gemälde	ɡəmɛːldə	2
gemäss	ɡəmɛːs	6
gemeinde	ɡəmaɪ̯ndə	9
gemeinsam	ɡəmaɪnzam	28
gemeinschaft	ɡəmaɪ̯nʃaft	6
gemüse	ɡəmyːzə	4
gemütlich	ɡəmyːtlɪç	2
gemütlicher	ɡəmyːtlɪçɐ	1
genau	ɡənaʊ̯	33
genauso	ɡənaʊ̯zoː	11
gene	ɡeːnə	2
genehmigen	ɡəneːmiɡən	1
genehmigung	ɡəneːmiɡʊŋ	4
general	ɡeːnəʁaːl	8
general	ɡɛnəʁaːl	8
generalprobe	ɡeneʀaːlpʀoːbə	1
generation	ɡeːnəʁat͡si̯oːn	9
generation	ɡɛnə-	9
generieren	ɡenəʁiːʁən	8
genetisch	ɡeneːtɪʃ	1
genetische	ɡeneːtɪʃə	1
genetisches	ɡeneːtɪʃəs	1
geniessen	ɡəniːsn̩	1
geniessen	ɡəniːsən	1
genommen	ɡənɔmən	13
gent	ɡɛnt	1
genug	ɡənuːk	25
genug	ɡənʊx	25
genüge	ɡənyːɡə	1
geologische	ɡeoloːɡɪʃə	1
georg	ɡeːɔrk	2
georg	ɡeːɔɐ̯k	2
georg	ɡeːɔrx	2
georg	ɡeːɔɐ̯x	2
gepflanzt	ɡəpflantst	1
geplant	ɡəplaːnt	23
gerade	ɡəraːdə	59
gerade	ɡraːdə	59
gerade	ɡəʁaːdə	59
geradeaus	ɡəʁaːdəʔaʊ̯s	1
gerät	ɡəʁɛːt	16
gerät	ɡəʁeːt	16
gerät	ɡəʁɛːt	16
gerät	ɡəʁeːt	16
geraten	ɡəʀaːtn̩	11
geraten	ɡəʀaːtən	11
geräusch	ɡəʁɔʏ̯ʃ	2
gerecht	ɡəʀɛçt	3
gerechtigkeit	ɡəʁɛçtɪçkaɪ̯t	1
gericht	ɡəʀɪçt	27
gerichte	ɡəʀɪçtə	3
gerichtshof	ɡəʀɪçt͡shoːf	3
gering	ɡəʁɪŋ	3
gering	ɡeːʁɪŋ	3
geringe	ɡəʀɪŋə	4
geringer	ɡəʀɪŋɐ	4
gerissen	ɡəʀɪsn̩	1
gerissen	ɡəʀɪsən	1
gern	ɡɛrn	15
gerne	ɡɛrnə	22
gerücht	ɡəʁʏçt	2
gesagt	ɡəzaːkt	21
gesagt	ɡəzaxt	21
gesamtzahl	ɡəzamttsaːl	1
geschäft	ɡəʃɛft	18
geschäfte	ɡəʃɛftə	5
geschätzt	ɡəʃɛt͡st	3
geschehen	ɡəʃeːən	8
geschehen	ɡəʃeːn	8
geschehen	ɡəʃeːən	8
gescheitert	ɡəʃaɪ̯tɐt	10
geschenk	ɡəʃɛŋk	4
geschichte	ɡəʃɪçtə	28
geschichtenerzähler	ɡəʃɪçtn̩ʔɛɐ̯tsɛːlɐ	1
geschichtenerzähler	ɡəʃɪçtənʔɛɐ̯tsɛːlɐ	1
geschirr	ɡəʃɪʁ	1
geschlagen	ɡəʃlaːɡŋ̩	3
geschlagen	ɡəʃlaːɡən	3
geschlecht	ɡəʃlɛçt	2
geschlossen	ɡəʃlɔsn̩	8
geschlossen	ɡəʃlɔsən	8
geschmack	ɡəʃmak	2
geschmäckle	ɡəʃmɛklə	1
geschoss	ɡəʃɔs	2
geschrieben	ɡəʃʁiːbən	7
geschwätz	ɡəʃvɛt͡s	1
geschwindigkeit	ɡəʃvɪndɪçkaɪ̯t	4
geschwindigkeiten	ɡəʃvɪndɪçkaɪ̯tən	1
gesehen	ɡəzeːən	20
gesellschaft	ɡəzɛlʃaft	26
gesetz	ɡəzɛts	17
gesetzgeber	ɡəzɛtsɡeːbɐ	1
gesetzgebers	ɡəzɛtsɡeːbɐs	2
gesetzlich	ɡəzɛt͡slɪç	3
gesicht	ɡezɪçt	7
gesichter	ɡəzɪçtɐ	3
gesindel	ɡəzɪndl̩	1
gespann	ɡəʃpan	2
gespräch	ɡəʃpʀɛːç	20
gesprächspartner	ɡəʃpʀɛːçspaʁtnɐ	1
gesprochen	ɡəʃpʁɔxn̩	9
gestalten	ɡəʃtaltən	6
geste	ɡeːstə	1
geste	ɡɛstə	1
geste	ʒɛstə	1
gestellt	ɡəʃtɛlt	16
gestern	ɡɛstərn	28
gestern	ɡɛstɐn	28
gestern	ɡɛstn	28
gestern	ɡɛstərn	28
gestern	ɡɛstɐn	28
gestohlen	ɡəʃtoːlən	4
gestorben	ɡəʃtɔʁbən	3
gestrickt	ɡəʃtʀɪkt	1
gestrüpp	ɡəʃtʀʏp	1
gesuch	ɡəzuːx	1
gesucht	ɡəzuːχt	8
gesund	ɡəzʊnt	2
gesundheit	ɡəzʊnthaɪ̯t	9
getan	ɡətaːn	8
getaucht	ɡətaʊ̯xt	1
getränk	ɡətʀɛŋk	1
getriebe	ɡətʀiːbə	3
gewähren	ɡəvɛːʁən	2
gewährleistung	ɡəvɛːʁlaɪ̯stʊŋ	1
gewalt	ɡəvalt	10
gewaltsam	ɡəvaltzaːm	2
gewerkschaft	ɡəvɛʁkʃaft	7
gewesen	ɡəveːzn̩	46
gewesen	ɡəveːzən	46
gewicht	ɡəvɪçt	4
gewinn	ɡəvɪn	13
gewinn	ɡɛvɪn	13
gewinne	ɡəvɪnə	8
gewinnen	ɡəvɪnən	19
gewinner	ɡəvɪnɐ	3
gewinns	ɡəvɪns	1
gewinnspiel	ɡəvɪnʃpiːl	1
gewiss	ɡəvɪs	2
gewissen	ɡəvɪsən	4
gewissheit	ɡəvɪshaɪ̯t	2
gewitter	ɡəvɪtɐ	1
gewöhnlich	ɡəvøːnlɪç	2
gewonnen	ɡəvɔnən	12
gewünscht	ɡəvʏnʃt	3
gezahlt	ɡətsaːlt	3
ghana	ɡaːna	1
gibt	ɡiːpt	198
gibt	ɡɪpt	198
gier	ɡiːɐ̯	2
gigabyte	ɡiːɡabai̯t	2
gilt	ɡɪlt	61
ging	ɡɪŋ	40
gitarren	ɡitaʀən	1
gitter	ɡɪtɐ	2
glänzen	ɡlɛnt͡sn̩	3
glarus	ɡlaːʀʊs	1
glas	ɡlaːs	2
glas	ɡlas	2
glasfaser	ɡlaːsfaːzɐ	2
glasfasern	ɡlaːsfaːzɐn	1
glaube	ɡlaʊ̯bə	13
glauben	ɡlaʊ̯bm̩	13
glauben	ɡlaʊ̯bən	13
glaubhaft	ɡlaʊ̯phaft	3
glaubwürdig	ɡlaʊ̯pvʏʁdɪç	1
glaubwürdigkeit	ɡlaʊ̯pvʏʁdɪçkaɪ̯t	3
gleich	ɡlaɪ̯ç	35
gleichen	ɡlaɪ̯çən	17
gleichsam	ɡlaɪ̯çzaːm	1
gleichsam	ɡlaɪ̯çzam	1
glied	ɡliːt	1
glück	ɡlʏk	14
glücklich	ɡlʏklɪç	3
glücklicherweise	ɡlʏklɪçɐvaɪ̯zə	1
glücksfall	ɡlʏksfal	2
glücksgefühl	ɡlʏksɡəfyːl	1
glühwein	ɡlyːvaɪ̯n	1
gnade	ɡnaːde	3
gnadenlos	ɡnaːdənloːs	1
gnädig	ɡnɛːdɪç	1
gnädig	ɡneːdɪç	1
gnu	ɡnu	1
go	ɡoː	1
goethe	ɡøːtə	2
golden	ɡɔldn̩	1
goldmünzen	ɡɔltmʏntsn̩	1
goldmünzen	ɡɔltmʏntsən	1
golf	ɡɔlf	2
googeln	ɡuːɡəln	1
google	ɡuːɡəl	33
gott	ɡɔt	8
gotteslästerung	ɡɔtəslɛstəʀʊŋ	1
göttingen	ɡœtɪŋən	1
gottschalk	ɡɔtʃalk	1
götze	ɡœtsə	4
grab	ɡʁaːp	1
grab	ɡʁap	1
grad	ɡʁaːt	8
grad	ɡʁaːt	8
graf	ɡraːf	1
graphen	ɡʀaːfɱ̩	1
graphen	ɡʀaːfən	1
gratis	ɡʁaːtɪs	2
gratwanderung	ɡʁaːtvandəʁʊŋ	2
graubünden	ɡʁaʊ̯bʏndən	1
gravitation	ɡʀavitat͡sɪ̯oːn	1
greifbar	ɡʁaɪ̯fbaːʁ	1
greifen	ɡʁaɪ̯fən	4
greifen	ɡʁaɪ̯fən	4
grenze	ɡʁɛntsə	14
grenzen	ɡʁɛntsən	14
griechenland	ɡʁiːçənlant	48
gries	ɡʁiːs	1
griff	ɡʀɪf	6
grippe	ɡʁɪpə	1
grob	ɡʁoːp	2
grob	ɡʁɔp	2
gros	ɡʁoːs	2
gross	ɡroːs	5
gross	ɡʁoːs	5
gross	ɡroːs	5
grossbritannien	ɡʁoːsbʁɪtanjən	1
grosse	ɡʁoːsə	8
grösse	ɡʀøːsə	2
grossen	ɡʁoːsn̩	16
grosser	ɡʁoːsɐ	2
grosser	ɡʁoːsɐ	2
grosses	ɡʀoːsəs	3
grössten	ɡʀøːstn̩	6
grössten	ɡʀøːstən	6
grösstenteils	ɡʁøːstəntaɪ̯ls	3
grösster	ɡʀøːstɐ	1
grossvater	ɡʁoːsfatɐ	1
grube	ɡʀuːbə	1
grübeln	ɡʀyːbəln	2
grün	ɡʁyːn	1
grund	ɡʁʊnt	25
gründe	ɡʀʏndə	7
gründen	ɡʀʏndn̩	11
gründen	ɡʀʏndən	11
gründer	ɡʀʏndɐ	2
grundschule	ɡʀʊntʃuːlə	1
gründung	ɡʁʏndʊŋ	2
gruppe	ɡʁʊpə	18
grütze	ɡrʏt͡sə	1
gta	ɡeːteʔaː	2
gucken	kʊkən	4
gucken	ɡʊkən	4
gültig	ɡʏltɪç	1
günstig	ɡʏnstɪç	1
gut	ɡuːt	145
gut	ɡʊt	145
gut	ɡuːt	145
guten	ɡuːtn̩	18
güter	ɡyːtɐ	1
gutes	ɡuːtəs	12
gymnasium	ɡʏmnaːziʊm	2
haare	haːʀə	2
haaresbreite	haːʀəsbʀaɪ̯tə	1
haarig	haːʁɪç	1
haas	haːs	1
hab	haːp	5
hab	hap	5
habe	haːbə	202
habe	haːbə	202
haben	haːbən	420
haben	ham	420
haben	haːbən	420
habt	haːpt	1
habt	hapt	1
hafen	haːfɱ̩	3
hafen	haːfən	3
haftbefehl	haftbəfeːl	2
häftling	hɛftlɪŋ	1
haftung	haftʊŋ	1
hagel	haːɡl̩	1
hagel	haːɡəl	1
hager	haːɡɐ	1
hahn	hɑːn	1
haiti	haiːti	1
haken	haːkŋ̩	1
haken	haːkən	1
haken	haːkən	1
halben	halbn̩	5
halber	halbəʁ	1
halbinsel	halpʔɪnzl	1
halbjahr	halpjaːɐ̯	8
halbwelt	halpvɛlt	1
half	half	4
hälfte	hɛlftə	18
halle	halə	6
hallenbad	halənbaːt	2
hallenbad	halənbat	2
hallo	halo	1
hallo	haloː	1
hals	hals	3
halt	halt	6
halt	halt	6
haltbar	haltbaːʀ	1
halte	haltə	9
halten	haltn̩	29
halten	haltən	29
haltlos	haltloːs	1
hamburger	hambʊʁɡɐ	13
hamburger	hɛmbœʁɡɐ	13
hamm	ham	1
hammer	hamɐ	2
hammer	hamɐ	2
hand	hant	17
hand	hɑnt	17
hand	hɑnd̥	17
handball	hantbal	1
hände	hɛndə	9
handel	handl̩	9
handeln	handəln	9
handeln	hɛndəln	9
händler	hɛndlɐ	4
handlung	handlʊŋ	1
handschuhfach	hantʃuːfax	1
handwerk	hantvɛʁk	2
handwerkskunst	kʊnst	1
handy	hɛndi	9
hängen	hɛŋən	5
hanne	hanə	1
hannover	hanoːfɐ	20
happy	hɛpi	2
harmlos	haʁmloːs	1
harmlos	haːmloːs	1
harren	haʁən	1
hart	haʁt	10
hart	haːt	10
hasskriminalität	haskriminalitɛːt	1
hässlich	hɛslɪç	1
hässliche	hɛslɪçə	1
hast	hast	4
hast	has	4
hast	haʃ	4
hast	has	4
hast	haʃ	4
hast	hast	4
hat	hat	666
hatte	hatə	234
hätte	hɛtə	49
hatten	hatn̩	74
hatten	hatən	74
hatten	hatn̩	74
hätten	hɛtn̩	38
hätten	hɛtən	38
hättet	hɛtət	1
haube	haʊ̯bə	1
hauch	haʊ̯x	1
häufchen	hɔʏfçən	1
haufen	haʊ̯fən	1
häufen	hɔʏ̯fən	1
häufiger	hɔɪ̯fɪɡɐ	5
hauptbahnhof	haʊ̯ptbaːnhoːf	1
hauptbahnhof	haʊ̯panoːf	1
hauptfeld	haʊ̯ptfɛlt	1
hauptrolle	haʊ̯ptʀɔlə	3
hauptsache	haʊ̯ptzaxə	3
hauptsächlich	haʊ̯ptzɛçlɪç	2
hauptstadt	haʊ̯ptʃtat	14
haus	haʊ̯s	25
hausarbeit	haʊ̯sʔaʁbaɪ̯t	1
hausarzt	haʊsaʁtst	1
hausaufgaben	haʊ̯sʔaʊ̯fɡaːbən	1
häuschen	hɔʏ̯sçən	1
hausen	haʊzən	2
häuser	hɔʏ̯zɐ	5
häusern	hɔɪ̯zɐn	1
hauses	haʊ̯zəs	2
hausfrau	haʊ̯sfʀaʊ	1
haushalt	haʊ̯shalt	2
hausmeister	haʊsmaɪstər	1
haustür	haʊ̯styːɐ̯	1
haut	haʊt	2
hautfarben	haʊ̯tfaʁbn̩	1
hawaii	havaɪ̯	2
hawaii	havaːʔi	2
hecht	hɛçt	2
heck	hɛk	1
heft	hɛft	1
heft	das‿hɛft	1
heftig	hɛftɪç	5
heidi	haɪ̯di	4
heiligen	haɪ̯lɪɡən	2
heim	haɪ̯m	3
heim	haɪ̯m	3
heimat	haɪ̯maːt	11
heimlich	haɪ̯mlɪç	1
heiraten	haɪ̯raːtən	2
heissen	haɪ̯sn̩	2
heissen	haɪ̯sən	2
heiter	haɪ̯tɐ	1
heizen	haɪ̯tsn̩	1
heizen	haɪ̯tsən	1
held	hɛlt	2
helfen	hɛlfn̩	29
helfer	hɛlfɐ	5
hellen	hɛlən	1
helligkeit	hɛlɪçkaɪ̯t	1
helm	ɦɛlm	1
helmut	hɛlmuːt	4
hemd	hɛmt	2
hemden	hɛmdn̩	3
hemdsärmelig	hɛmt͡sʔɛʁməlɪç	1
hemisphäre	hemisfɛːʀə	1
hengst	hɛŋst	2
hepatitis	hepatiːtɪs	1
herausgeben	hɛʀaʊ̯sɡeːbn̩	1
herausgeber	həʀaʊ̯sɡeːbɐ	4
herbst	hɛʁpst	16
herd	heːɐ̯t	2
herd	hɛɐ̯t	2
herde	heːɐ̯də	1
herde	hɛʁdə	1
herdprämie	heːɐ̯tprɛːmi̯ə	1
herr	hɛʁ	21
herr	hɛr	21
herrschaft	hɛʁʃaft	2
herrscher	hɛʁʃɐ	2
hersteller	heːɐ̯ʃtɛlɐ	20
herum	hɛʀʊm	3
herunterladen	hɛʀʊntɐlaːdən	6
herunterspielen	hɛʁʊntəʁʃpiːlən	1
herz	hɛʁts	4
herzen	hɛʁtsn̩	5
hetze	hɛt͡sə	3
heuer	hɔʏ̯ɐ	2
heuer	hɔʏ̯ɐ	2
heuschnupfen	hɔʏ̯ʃnʊpfən	1
heute	hɔʏ̯tə	107
heute	hɔɪ̯tə	107
heutzutage	hɔʏ̯tsutaːɡə	3
hexer	hɛksɐ	2
hier	hiːɐ̯	136
hier	hiːɐ	136
hiermit	hiːɐ̯mɪt	1
hiervon	hiːɐfɔn	1
highlight	haɪ̯laɪ̯t	2
hildebrand	hɪldəbʀant	1
hilfe	hɪlfə	22
hilflos	hɪlfloːs	2
hilflosigkeit	hɪlfloːzɪçkaɪ̯t	1
hilfreich	hɪlfʀaɪ̯ç	1
hilft	hɪlft	12
himmelskörper	hɪml̩skœʁpɐ	1
hin	hɪn	34
hindern	hɪndɐn	3
hinfällig	hɪnfɛlɪç	1
hinlänglich	hɪnlɛŋlɪç	2
hinnehmbar	hɪnneːmbaːɐ̯	1
hinsehen	hɪnzeːən	1
hinsicht	hɪnzɪçt	3
hinten	hɪntən	8
hinter	hɪntɐ	35
hinterer	hɪntəʁɐ	1
hinterkopf	hɪntɐkɔpf	1
hinterlassen	hɪntɐlasn̩	4
hinterwäldlerisch	hɪntɐvɛltləʀɪʃ	1
hinunter	hɪnʊntɐ	1
hinweg	hɪnvɛk	6
hinwerfen	hɪnvɛʁfn̩	1
hinzufügen	hɪntsuːfyːɡŋ̩	6
hinzufügen	hɪntsuːfyːɡən	6
hirsch	hɪʁʃ	2
historiker	hɪstoːʁikɐ	3
historisch	hɪstoːʀɪʃ	1
hitze	hɪtsə	2
hobby	hɔbi	1
hoch	hoːx	36
hochdeutsch	hoːxdɔʏ̯tʃ	1
hochdeutsch	hoːχdɔɪ̯tʃ	1
hochschule	hoːxʃuːlə	3
hochsprung	hoːχʃpʀʊŋ	1
höchstens	høːçtəns	3
hochzeit	hɔxt͡saɪ̯t	1
hochzeit	hoːxt͡saɪ̯t	1
hockey	hɔki	3
hof	hoːf	3
hof	hɔf	3
hoffen	hɔfɱ̩	8
hoffen	hɔfən	8
hoffnung	hɔfnʊŋ	10
hoffnungen	hɔfnʊŋən	4
hohe	hoːə	19
höhe	høːə	26
hoheit	hoːhaɪ̯t	1
höhepunkt	høːəpʊŋkt	4
höher	høːɐ	12
hohn	hoːn	1
hole	hoːlə	1
holen	hoːlən	9
holländer	hɔlɛndɐ	4
hölle	hœlə	2
holz	hɔlts	1
hölzer	hœltsɐ	1
hölzern	hœlt͡sɐn	2
homo	hoːmo	1
hongkong	hɔŋkɔŋ	3
honig	hoːnɪç	3
hören	høːrən	8
hören	høːɐn	8
hören	høːɐ̯n	8
hören	hœɐ̯n	8
hören	høːʀən	8
horizont	hoʁit͡sɔnt	1
horst	hɔʁst	7
hotel	hotɛl	8
huawei	huːavaɪ̯	5
hübsch	hʏpʃ	1
hubschrauber	huːpʃʁao̯bɐ	1
huckepack	hʊkəpak	1
hügel	hyːɡl̩	1
human	humaːn	2
hund	hʊnt	4
hunde	hʊndə	2
hundert	hʊndɐt	13
hundertstel	hʊndɐt͡stl̩	2
hunger	hʊŋɐ	1
hungern	hʊŋəʁn	1
hürde	hʏʁdə	2
hure	huːʁə	2
hut	huːt	3
i	ʔiː	3
ibiza	iːbɪtsa	2
ibiza	ibɪtsa	2
ich	ɪç	448
ideal	ideaːl	2
idee	ʔideː	10
ideen	ʔideːən	9
identifizieren	ʔidɛntifitsiːɐ̯n	1
identifizieren	ʔidɛntifitsiːʀən	1
identisch	idɛntɪʃ	1
identität	idɛntitɛːt	1
identität	idɛntiteːt	1
ideologie	ideoloɡiː	2
ihm	iːm	72
ihm	əm	72
ihn	iːn	69
ihn	ən	69
ihr	ʔiːɐ̯	151
ihr	ɐ	151
ihr	ʔiːɐ̯	151
ihre	ʔiːʁə	223
ihrem	ʔiːʁəm	61
ihrer	ʔiːʁɐ	89
illegal	ɪleɡaːl	5
im	ɪm	1331
immer	ɪmɐ	194
immobilie	ɪmobiːli̯ə	2
imperialismus	ɪmpeʁialɪsmʊs	1
imperialismus	ɪmpʁɪɐ̯lɪsmʊs	1
impfung	ɪmpfʊŋ	1
implementierung	ɪmpləmɛntiːʁʊŋ	3
implizit	ɪmplitsɪt	1
in	ʔɪn	2897
indem	ɪndeːm	11
index	ɪndɛks	2
indiens	ɪndiəns	1
indirekt	ɪndiʁɛkt	3
indonesien	ɪndoneːziən	3
info	ɪnfoː	3
informatik	ɪnfɔɐ̯maːtɪk	1
information	ɪnfɔʁmatsjoːn	6
informativ	ɪnfɔʁmatiːf	1
informieren	ɪnfoʁmiːʁən	4
inhaber	ɪnhaːbɐ	1
inhalt	ɪnhalt	6
innenleben	ɪnənleːbn̩	1
innenstadt	ɪnənʃtat	3
innereien	ɪnəʁaɪ̯ən	1
innerhalb	ɪnɐhalp	24
ins	ɪns	77
insbesondere	ɪnsbəzɔndəʁə	21
insel	ɪnzəl	6
inseln	ʔɪnzl̩n	2
insgesamt	ɪnsɡəzamt	59
insider	ɪnsaɪ̯dɐ	3
inspiration	ʔɪnspiʀatsi̯oːn	1
instagram	ɪnstaɡʁam	7
instagram	ɪnstəɡɹɛm	7
installation	ɪnstalatsjoːn	3
installation	ɪnʃtalatsjoːn	3
installieren	ɪnstaliːʁən	8
instandhaltung	ɪnʃtanthaltʊŋ	2
integrieren	ɪntəɡʁiːʁən	1
intellektuelle	ɪntelɛktuɛlə	1
intellektueller	ɪntelɛktuɛlɐ	1
intelligent	ʔɪntɛliɡɛnt	1
intelligente	ʔɪntɛliɡɛntə	2
intensiv	ɪntɛnziːf	3
intention	ɪntɛnzjoːn	1
intention	ɪntɛntsjoːn	1
interessant	ɪntəʁɛsant	8
interessant	ɪntʁəsant	8
interesse	ɪntərɛsə	17
interesse	ɪntrɛsə	17
interesse	ɪntɛrɛsːə	17
interessieren	ɪntəʁɛsiːʁən	3
interessieren	ɪntʁəsiːɐn	3
interessieren	ɪntʁəsiːɐ̯n	3
interessiert	ɪntəʀsiːɐ̯t	7
internet	ɪntɐnɛt	24
interpretation	ɪntɐpretatsioːn	1
interpretieren	ʔɪntɐpʀetiːʀən	1
interview	ɪntɐvjuː	6
interviews	ʔɪntɐvjuːs	3
investition	ʔɪnvɛstitsi̯oːn	4
investitionen	ʔɪnvɛstitsi̯oːnən	10
investor	ɪnvɛstoɐ	3
inzwischen	ɪnt͡svɪʃn̩	30
irak	iʁaːk	9
iraker	iʁaːkɐ	1
iran	iʁaːn	8
irgendein	ɪrɡəntaɪ̯n	1
irgendein	ɪrɡəntaɪ̯n	1
irgendwann	ɪʁɡəntvan	10
irgendwelche	ɪʁɡn̩tvɛlçə	3
irgendwo	ɪʁɡəntvoː	2
ironie	iʁoniː	1
islamische	ɪslaːmɪʃə	5
islamische	ɪslamɪʃə	5
islamisierung	ɪslamiziːʁʊŋ	2
island	iːslant	2
israel	ɪsʀaeːl	5
isst	ɪst	2
ist	ɪst	1362
ist	ɪs	1362
istanbul	ɪstanbuːl	1
istanbul	iːs-	1
istanbul	-tam-	1
istanbul	bʊl	1
italien	itaːli̯ən	17
italiener	itali̯eːnɐ	7
italiens	itaːli̯əns	1
ja	jaː	92
jacken	jakən	1
jacqueline	ʒakliːn	3
jagd	jaːkt	1
jagd	jaxt	1
jagen	jaːɡən	2
jäger	jɛːɡɐ	3
jagt	jaːkt	3
jagt	jaːxt	3
jaguar	jaːɡu̯aːɐ̯	2
jahr	jaːɐ̯	172
jahre	jaːʀə	107
jahresende	jaːʁəsʔɛndə	6
jahresende	jaːʁəsʔɛndə	6
jahrestag	jaːʁəstaːk	3
jahreswechsel	jaːʀəsvɛksl̩	1
jahrhundert	jaːɐ̯hʊndɐt	4
jährlich	jɛːɐ̯lɪç	12
jahrzehnt	jaːɐ̯tseːnt	1
jahrzehnte	jaːɐ̯t͡seːntə	4
jahrzehntelang	jaːɐ̯tseːntəlaŋ	1
jakob	jaːkɔp	1
jammer	jamɐ	1
jammern	jaməʁn	2
jan	jan	9
jan	jaːn	9
jänner	jɛnːɐ	3
jänner	jɛnːər	3
januar	januaːr	33
januar	januaːɐ̯	33
januar	janʊɐ̯	33
januar	jaːnʊɐ̯	33
japan	jaːpan	4
jasmin	jasmiːn	3
jazz	d͡ʒɛs	1
jazz	d͡ʒɛːs	1
jazz	jat͡s	1
je	jeː	38
jede	jeːdə	23
jedem	jeːdəm	16
jedem	jeːbm̩	16
jeden	jeːdn̩	34
jedenfalls	jeːdənfals	16
jeder	jeːdɐ	43
jedes	jeːdəs	18
jedoch	jeːdɔx	86
jemand	jeːmant	17
jemen	jeːmən	1
jemen	jɛmən	1
jener	jeːnɐ	7
jenseits	jeːnzaɪ̯t͡s	2
jerusalem	jeʀuːzalɛm	1
jesus	jeːzʊs	1
jet	dʒɛt	2
jet	ʒɛt	2
jet	tʃɛt	2
jetzt	jɛtst	168
jetzt	jɛts	168
jeweils	jeːvaɪ̯ls	21
jo	jɔː	1
jo	joː	1
job	dʒɔp	11
jobs	dʒɔps	9
jockey	d͡ʒɔkɪ	1
joggen	d͡ʒɔɡn̩	1
jordanien	jɔʁdaːniən	3
josef	joːzɛf	3
josef	joːzəf	3
josef	joːzeːf	3
jota	joːta	1
journalist	ʒʊʁnalɪst	5
journalisten	ʒʊʁnalɪstn	10
jubiläum	jubilɛːʊm	1
jugend	juːɡənt	5
jugendliche	juːɡəntlɪçə	7
jugendlicher	juːɡəntlɪçɐ	1
jugendlicher	juːŋklɪçɐ	1
jugendstil	juːɡŋ̩tstiːl	1
jugendstil	juːɡŋ̩tʃtiːl	1
jugoslawien	juɡoslaːviən	1
jul	juːl	1
juli	juːli	26
julia	juːli̯a	3
jung	jʊŋ	1
junge	jʊŋə	30
jünger	jʏŋɐ	1
jünger	jʏŋɐ	1
jungfrau	jʊŋfʁaʊ̯	1
jungs	jʊŋs	2
jüngst	jʏŋst	9
jüngsten	jʏŋstn̩	14
jüngsten	jʏŋstən	14
juni	juːni	28
junker	jʊŋkɐ	1
jupiter	juːpitɐ	3
jupp	jʊp	1
jurist	juʁɪst	1
justiz	jʊstiːts	9
justiz	jʊstɪts	9
k	kaː	1
kabel	kaːbəl	2
kader	kaːdɐ	5
kaffee	kafe	4
kaffee	kafeː	4
kaffee	kafə	4
käfig	kɛːfɪç	1
käfig	keːfɪç	1
käfig	kɛːfɪɡ̊	1
kairo	kaɪ̯ʁo	2
kaiser	kaɪ̯zɐ	4
kaiserreich	ka͜izɐra͜iç	1
kalender	kalɛndɐ	2
kalifat	kalifaːt	2
kalifornien	kalifɔʁniən	6
kalt	kalt	3
kamen	kaːmən	17
kammer	kamɐ	3
kampagne	kampanjə	6
kampf	kampf	25
kämpfe	kɛmpfə	6
kämpfen	kɛmpfən	10
kämpfer	kʰɛmpfɐ	6
kanada	kanada	9
kanadier	kanaːdiɐ	1
kanal	kanaːl	1
kandidat	kandidaːt	5
kandidieren	kandidiːʁən	2
kann	kan	287
kannst	kanst	4
kantine	kantiːnə	1
kanton	kantoːn	13
kanton	kɑnton	13
kanzlerin	kantsləʀɪn	11
kapital	kapitaːl	3
kapitalismus	kapitalɪsmʊs	2
kapitän	kapitɛːn	7
kapitel	kapɪtəl	1
kapitel	kapiːtəl	1
kaputt	kapʊt	2
kardiologe	kaʁdi̯oloːɡə	1
karikaturisten	kaʀikatuʀɪstn̩	1
karlsruhe	kaɐ̯lsʁuːə	5
karlsruher	kaʁlsʀuːɐ	2
kärnten	kɛʁntən	7
karte	kaʁtə	7
karte	kaːtə	7
kartoffel	kaʁtɔfəl	1
kartoffel	kɐtɔfəl	1
kasachstan	kazaxstaːn	4
kaschmir	kaʃmiɐ̯	1
kaschmir	kaʃmiːɐ̯	1
käse	kɛːzə	1
käse	keːzə	1
kaserne	kazɛɐ̯nə	1
kasse	kasə	12
kassel	kasl̩	3
kassel	kasəl	3
kassieren	kasiːrən	1
kasten	kastn̩	1
katalane	katalaːnə	1
katalog	kataloːk	1
katalonien	kataloːni̯ən	1
kate	kaːtə	2
kategorisch	kateɡoːʀɪʃ	1
katze	kʰɑtsə	1
katze	kʰatsə	1
katze	kɑtːsə	1
kauf	kaʊ̯f	8
käufer	kɔɪ̯fɐ	4
kaufhäuser	kaʊ̯fhɔɪ̯zɐ	1
kaufmann	kaʊ̯fman	1
kaum	kaʊ̯m	50
kehren	keːʁən	1
kein	kaɪ̯n	104
keine	kaɪ̯nə	162
keinem	kaɪ̯nəm	10
keinem	kaɪm	10
keinen	kaɪ̯nən	38
keinen	kaɪ̯n	38
keiner	kaɪ̯nɐ	11
keinerlei	kaɪ̯nɐlaɪ̯	1
keineswegs	kaɪ̯nəsveːks	4
keller	kɛlɐ	7
kellner	kɛlnɐ	2
kenia	keːni̯a	2
kenianer	keni̯aːnɐ	1
kennen	kɛnən	13
kenntnis	kɛntnɪs	1
kennzeichnung	kɛnt͡saɪ̯çnʊŋ	2
kennzeichnungen	kɛnt͡saɪ̯çnʊŋən	1
kern	kɛʁn	6
kerze	kɛʁtsə	1
kessel	kɛsəl	1
kette	kɛtə	1
kiel	kiːl	3
kiffer	kɪfɐ	1
kilian	kiːlian	2
kilian	kiːljan	2
kilogramm	kiloɡʀam	2
kilogramm	kiːloɡʁam	2
kilometer	kilomeːtɐ	16
kilometerstand	kilomeːtɐʃtant	1
kilt	kɪlt	1
kind	kɪnt	20
kinder	kɪndɐ	46
kindergarten	kɪndɐɡaːɐ̯tn̩	2
kindermädchen	kɪndɐmɛːtçən	1
kinderschänder	kʰɪndɐʃɛndɐ	1
kinderschänder	kʰind̥ərʃɛnd̥ər	1
kinderwagen	kɪndɐvaːɡən	1
kino	kiːnoː	3
kinos	kiːnoːs	1
kippen	kɪpən	2
kirche	kɪʁçə	9
kiste	kɪstə	2
kitsch	kɪt͡ʃ	1
klagen	klaːɡən	3
klagen	klaːɡən	3
kläger	klɛːɡɐ	1
kläger	kleːɡɐ	1
klang	klaŋ	1
klappen	klapən	1
klar	klaːɐ̯	38
klären	klɛːʁən	3
klarheit	klaːrhaɪ̯t	3
klärung	klɛːʁʊŋ	1
klasse	klasə	4
klauen	klaʊ̯ən	1
klauen	klaʊ̯n	1
klauen	klaʊ̯ən	1
kleber	kleːbɐ	4
klee	kleː	2
kleidung	klaɪ̯dʊŋ	7
klein	klaɪ̯n	7
kleine	klaɪ̯nə	27
kleinen	klaɪ̯nən	23
kleiner	klaɪ̯nɐ	6
kleinkind	klaɪ̯nkɪnt	1
kleinsten	klaɪ̯nstn̩	1
kleinsten	klaɪ̯nstən	1
klick	klɪk	1
klick	klɪk	1
klima	kliːma	4
klingen	klɪŋən	1
klopapier	kloːpapiːɐ̯	1
kloster	kloːstɐ	1
klub	klʊp	9
klug	kluːk	3
kluge	kluːɡə	1
knabe	knaːbə	1
knallhart	knalhaʁt	1
knapp	knap	32
knappe	knapə	3
knappen	knapm̩	2
knappen	knapən	2
knast	knast	1
kneipe	knaɪ̯pə	1
knicks	knɪks	1
knoblauch	knoːplaʊ̯x	1
knoblauch	knɔplaʊ̯x	1
knoblauch	knoːblaʊ̯x	1
knoten	knoːtən	3
knutschen	knuːtʃən	1
koalition	koalit͡si̯oːn	5
koch	kɔχ	10
kochen	kɔχən	1
ködern	køːdɐn	1
koffer	kɔfɐ	3
kohl	koːl	1
kohle	koːlə	2
köhler	køːlɐ	1
kojote	kojoːtə	1
koks	koːks	1
kollektiv	kɔlɛktiːf	2
kollektiv	kɔlɛktiːf	2
kollektiven	kɔlɛktiːvən	1
koller	kɔlɐ	2
köln	kœln	16
kölner	kœlnɐ	3
kolumbien	kolʊmbiən	1
kombüse	kɔmbyːzə	1
komiker	koːmikɐ	1
komisch	koːmɪʃ	1
komm	kɔm	1
komma	kɔma	1
komma	kɔma	1
kommen	kɔmən	71
kommentar	kɔmɛntaːɐ̯	22
kommentarlos	kɔmɛntaːɐ̯loːs	1
kommissar	kɔmɪsaːɐ̯	3
kommt	kɔmt	85
kommunikation	komunikat͡si̯oːn	10
kommunismus	kɔmunɪsmʊs	1
kompensieren	kɔmpɛnziːɐ̯n	1
kompensieren	kɔmpɛnziːʀən	1
kompromissbereit	kɔmpʀomɪsbəʀaɪ̯t	1
konfigurieren	kɔnfiɡuʁiːʁən	1
konflikt	kɔnflɪkt	3
könig	køːnɪç	4
könig	køːnɪk	4
königin	køːnɪɡɪn	1
königreich	køːnɪkʁai̯ç	4
königs	køːnɪçs	1
konjunktivitis	kɔnjʊŋktiviːtɪs	1
konkurrenz	kɔnkʊʁɛnt͡s	8
konkurrenzfähig	kɔŋkʊʀɛnt͡sfɛːɪç	1
könne	kœnə	31
können	kœnən	250
könnt	kœnt	3
konnte	kɔntə	70
könnte	kœntə	91
konnten	kɔntn̩	19
konnten	kɔntən	19
könnten	kœntn̩	50
könnten	kœntən	50
konsens	kɔnzɛns	1
konsens	kɔnzɛns	1
konsequenz	kɔnzekvɛnt͡s	3
konsole	kɔnzoːlə	5
konstant	kɔnstant	2
konstanz	kɔnstant͡s	2
konstanz	kɔnstant͡s	2
konstanz	kɔnʃtant͡s	2
konsum	kɔnzuːm	2
konsument	kɔnzumɛnt	1
konsumenten	kɔnzumɛntn	1
kontakt	kɔntakt	17
kontaktieren	kɔntaktiːʁən	1
konten	kɔntn̩	4
konten	kɔntən	4
konter	kɔntɐ	1
kontinent	kɔntinɛnt	1
kontraproduktiv	kɔntʁapʁodʊktiːf	1
kontroverse	kɔntʁovɛʁzə	1
konzentration	kɔntsɛntʀatsi̯oːn	3
konzentrationslager	kɔntsɛntʁatsi̯oːntslaːɡɐ	1
konzentrieren	kɔntsɛntʀiːʀən	5
konzepte	kɔntsɛptə	1
konzern	kɔnt͡sɛʁn	25
konzert	kɔntsɛɐ̯t	4
kooperieren	koʔɔpəʀiːʀən	3
kopf	kɔpf	24
köpfe	kœpfə	3
kopfes	kɔpfəs	1
kopfhörer	kɔpfhøːʀɐ	1
kopftuch	kɔpftuːχ	1
kopien	kopiːən	3
kopieren	kopiːɐ̯n	1
kopieren	kopiːʀən	1
kopp	kɔp	1
korn	kɔrn	2
körper	kœrpər	11
körperlich	kœʁpɐlɪç	2
korrekt	kɔʁɛkt	2
korrekt	ko-	2
korrupt	kɔʁʊpt	2
korrupt	koʁʊpt	2
kos	koːs	1
kosten	kɔstən	38
kosten	kɔstn̩	38
kosten	koːstən	38
kostenfrei	kɔstn̩fʀaɪ̯	1
kostenlos	kɔstn̩loːs	12
kostenpflichtig	kɔstn̩pflɪçtɪç	1
kostet	kɔstət	11
kostet	koːstət	11
kötter	kœtɐ	1
kraft	kʁaft	21
kraft	kʁɑft	21
kraftakt	kʁaftakt	1
kräftig	kʀɛftɪç	5
kraftraum	kʁaftʁaʊ̯m	1
kraftvoll	kʀaftfɔl	1
kraftwerk	kʀaftvɛʁk	3
kraftwerke	kʀaftvɛʁkə	2
kragen	kʁaːɡən	1
krämer	kʀɛːmɐ	2
krampfhaft	kʀampfhaft	1
krank	kʁaŋk	1
krankenhaus	kʁaŋkənhaʊ̯s	11
krankenhäuser	kʀaŋkn̩hɔɪ̯zɐ	1
kranz	kʁants	1
krasser	kʀasɐ	1
krawatte	kʀavatə	2
kreation	kʁeːatsjoːn	1
kreativ	krɛatiːf	1
krebs	kʁeːps	5
krebs	kʁɛps	5
kredit	kʁediːt	5
kredit	kʁedɪt	5
krefeld	kʁeːfɛlt	2
kreis	kraɪ̯s	6
kreise	kʀaɪ̯zə	3
kreisen	kʀaɪ̯zn̩	2
kreisen	kʀaɪ̯zən	2
kreisen	kʀaɪ̯zn̩	2
kreisen	kʀaɪ̯zən	2
kreuz	kʁɔʏ̯ts	2
kreuzen	kʁɔʏ̯tsən	5
kreuzfahrt	kʀɔɪ̯tsfaːɐ̯t	2
krieg	kʁiːk	22
krieg	kriːç	22
kriegen	kriːɡən	5
kriegen	kriəɡən	5
kriegen	kʀiːɡŋ̩	5
kriegen	kʀiːɡən	5
kriegsschiff	kʀiːksʃɪf	1
kriegt	kʁiːkt	2
kriegt	kʁɪkt	2
kriegt	kʁɪçt	2
krimi	krɪmi	2
kripo	kʁiːpo	3
kripo	kʁɪpo	3
krippe	kʁɪpə	1
krise	kʀiːzə	16
krisensicher	kʀiːzənzɪçɐ	1
kriterium	kʀiteːʀiʊm	1
kritik	kʁitiːk	29
kritik	kʁitɪk	29
kritiker	kʁiːtɪkɐ	8
kritiker	kʁɪtɪkɐ	8
kritisieren	kʀitiziːʀən	2
kroatien	kroaːtsiən	5
krönung	kʁøːnʊŋ	1
kröten	kʀøːtn̩	1
kröten	kʀøːtən	1
kruste	kʁʊstə	1
kuba	kuːba	3
kubaner	kubaːnɐ	1
küche	kʏçə	2
küche	kyːçə	2
kuchen	kuːxən	2
küchenschrank	kʏçn̩ʃʀaŋk	1
kuckuck	kʊkʊk	1
kuckuck	kʊkʊk	1
kugel	kuːɡəl	2
kuh	kuː	1
kühl	kyːl	1
kühle	kyːlə	1
kühle	kyːlə	1
kühlen	kyːlən	2
kulinarisch	kulinaːʀɪʃ	1
kultur	kʊltuːɐ̯	5
kund	kʊnt	1
kunde	kʊndə	7
kunden	kʊndən	39
kündigung	kʏndɪɡʊŋ	4
kundschaft	kʊntʃaft	1
künftig	kʏnftɪç	25
kunst	kʊnst	6
künstler	kʏnstlɐ	10
künstlich	kʏnstlɪç	2
kupfer	kʊpfɐ	1
kuppe	kʊpə	1
kuppel	kʊpl̩	1
küren	kyːʁən	1
küren	kyːʁən	1
kurse	kʊʁsə	4
kurse	kʊɐ̯sə	4
kurz	kʊʁt͡s	43
kürze	kʏʁt͡sə	4
kürzen	kʏʁtsən	2
kürzlich	kʏʁtslɪç	14
küsse	kʰʏsə	1
küssen	kʏsən	1
küste	kʏstə	5
l	ʔɛl	4
lab	lap	1
lache	laːxə	2
lache	laxə	2
lache	laxə	2
lache	laχə	2
lächeln	lɛçəln	2
lächeln	lɛçəln	2
lachen	laχn̩	6
lachen	laːχn̩	6
lächerlich	lɛçɐlɪç	1
lade	laːdə	1
laden	laːdən	4
laden	laːdən	4
lage	laːɡə	33
lagen	laːɡən	3
lagen	laːɡən	3
lager	laːɡɐ	4
lagern	laːɡɐn	1
lahm	laːm	4
laien	laɪ̯ən	2
lake	laːkə	2
lamm	lam	1
land	lant	60
länder	lɛndɐ	30
landeskirche	landəskɪʁçə	1
landkreis	lantkʀaɪ̯s	2
landschaft	lantʃaft	2
landwirte	lantvɪʁtə	1
landwirtschaft	lantvɪʁtʃaft	5
lang	laŋ	30
lang	laŋk	30
länge	lɛŋə	2
langen	laŋən	10
langer	laŋɐ	6
langes	laŋəs	1
länglich	lɛŋlɪç	1
langsam	laŋzaːm	13
langsame	laŋzaːmə	1
langsamen	laŋzaːmən	1
langsamer	laŋzaːmɐ	2
langsameren	laŋzaːməʁən	1
langsames	laŋzaːməs	1
langweilig	laŋvaɪ̯lɪç	1
laptop	lɛptɔp	3
lärm	lɛʀm	3
las	laːs	5
lass	las	1
lasse	lasə	2
lasst	last	1
lässt	lɛst	58
last	last	3
laster	lastɐ	1
lateinamerika	lataɪ̯nameːʁika	3
latte	latə	2
latz	lats	1
lau	laʊ̯	1
lauern	lauɐn	2
lauf	laʊ̯f	7
laufen	laʊ̯fən	12
laufen	laʊ̯fn̩	12
laufzeit	laʊ̯ftsaɪ̯t	7
laune	laʊ̯nə	2
lauschen	laʊ̯ʃn̩	1
lauschen	laʊ̯ʃən	1
laut	laʊ̯t	81
laute	laʊ̯tə	3
laute	laʊ̯tə	3
lauter	laʊ̯tɐ	2
lauthals	laʊ̯thals	1
lautlos	laʊ̯tloːs	1
lautsprecher	laʊ̯tʃpʁɛçɐ	2
lautstark	laʊ̯tʃtaʁk	1
leben	leːbən	76
leben	leːbən	76
lebendig	lebɛndɪç	1
lebensmittel	leːbm̩smɪtl̩	4
lebensmittel	leːbənsmɪtəl	4
lebensräume	leːbm̩sʀɔɪ̯mə	1
lebensräume	leːbənsʀɔɪ̯mə	1
lebensweg	leːbənsveːk	1
lebensweise	leːbn̩svaɪ̯zə	1
lebt	leːpt	16
lecken	lɛkŋ̩	1
lecken	lɛkən	1
lecker	lɛkɐ	1
leder	leːdɐ	5
lee	leː	3
leer	leːɐ̯	9
leeren	leːɐ̯n	2
leeren	leːʁən	2
legalisierung	leɡaliziːʀʊŋ	1
legen	leːɡŋ̩	14
legen	leːɡən	14
legende	leɡɛndə	1
legt	leːkt	13
legt	leːçt	13
lehnen	leːnən	4
lehre	leːʀə	2
lehren	leːʁən	2
lehren	leːɐ̯n	2
lehren	leːʀən	2
lehrer	leːʁɐ	14
lehrerin	leːʁəʁɪn	5
lehrling	leːɐ̯lɪŋ	2
leib	laɪ̯p	2
leiche	laɪ̯çə	3
leicht	laɪ̯çt	26
leichter	laɪ̯çtɐ	9
leichter	laɪ̯çtɐ	9
leichtfertig	laɪ̯çtfɛʁtɪç	1
leichtsinnig	laɪ̯çtzɪnɪç	1
leid	laɪ̯t	1
leid	laɪ̯t	1
leiden	laɪ̯dən	6
leiden	laɪ̯dən	6
leidenschaft	laɪ̯dn̩ʃaft	2
leidenschaft	laɪ̯dənʃaft	2
leider	laɪ̯dɐ	23
leider	laɪ̯dɐ	23
leihen	laɪ̯ən	1
leipzig	laɪptsɪç	24
leipzig	laɪptsɪk	24
leise	laɪzə	2
leisten	laɪ̯stn̩	16
leisten	laɪ̯stn̩	16
leistung	laɪ̯stʊŋ	17
leistungsschutzrecht	laɪstʊŋɡsʃʊt͡sʁɛçt	1
leitartikel	laɪ̯taʁtiːkl̩	2
leiter	laɪ̯tɐ	11
leiterin	laɪ̯təʀɪn	1
leitwolf	laɪ̯tvɔlf	1
lektüre	lɛktyːʀə	2
lenken	lɛŋkən	1
lenker	lɛŋkɐ	1
lernen	lɛɐnən	9
les	leːs	2
lese	leːzə	4
lesen	leːzn̩	21
lesenswert	leːzn̩sveːɐ̯t	1
leser	leːzɐ	9
letten	lɛtən	1
lettland	lɛtlant	3
letztendlich	lɛtstʔɛntlɪç	5
letzter	lɛt͡stɐ	4
letztlich	lɛtstlɪç	7
leuchte	lɔʏ̯çtə	1
leugnen	lɔɪ̯ɡnən	1
leute	lɔʏ̯tə	27
level	lɛvl̩	2
leverkusen	leːvɐkuːzn̩	10
lexikon	lɛksikɔn	1
libanon	liːbanɔn	1
liberia	libeːʁia	3
libido	liːbidoː	1
libido	libiːdoː	1
libyen	liːby̯ən	4
libyen	liːbi̯ən	4
libyen	lyːbi̯ən	4
licht	lɪçt	11
licht	lɪçt	11
lieb	liːp	2
liebe	liːbə	3
liebe	liːbə	3
lieben	liːbən	3
lieben	liːbm̩	3
lieben	liːbən	3
lieber	liːbɐ	17
lieber	liːbɐ	17
liebhaber	liːphaːbɐ	2
lieblos	liːploːs	1
liechtensteiner	lɪçtn̩ʃtaɪ̯nɐ	1
lied	liːt	2
lieder	liːdɐ	5
liedern	liːdɐn	2
liedes	liːdəs	1
liefern	liːfɐn	14
lieferung	liːfəʀʊŋ	3
liege	liːɡə	6
liegen	liːɡən	36
liegenschaft	liːɡənʃaft	1
liegt	liːkt	60
liegt	liːçt	60
liess	liːs	2
liesse	liːsə	1
liessen	liːsn̩	2
liessen	liːsən	2
limousine	lɪmuziːnə	1
limousine	liː-	1
limousine	-mo-	1
lindner	lɪntnɐ	1
lineal	lineaːl	1
linie	liːni̯ə	7
link	lɪŋk	2
link	liŋk	2
linke	lɪŋkə	11
links	lɪŋks	16
linse	lɪnzə	1
lisa	liːza	2
litauen	lɪtaʊ̯ən	2
liter	lɪtɐ	3
liter	liːtɐ	3
literarisch	lɪtəʀaːʀɪʃ	1
literatur	lɪtəʀatuːɐ̯	3
livestream	laɪ̯fstriːm	1
lizenz	litsɛnts	1
lizenzieren	litsɛnsiːrən	1
lizenzieren	litsɛntsiːrən	1
lkw	ɛlkaveː	5
lkw	ɛlkaveː	5
lob	loːp	4
lobby	lɔbi	1
lobpreis	loːppʀaɪ̯s	1
loch	lɔx	2
lockern	lɔkɐn	3
logik	loːɡɪk	3
lohn	loːn	4
löhne	løːnə	3
lokal	lokaːl	2
lokführer	lɔkfyːʀɐ	4
london	lɔndɔn	15
london	lɔndn̩	15
los	loːs	18
los	lɔs	18
los	loːs	18
löschen	lœʃən	5
losen	loːzən	1
losgehen	loːsɡeːən	2
lösung	løːzʊŋ	25
loswerden	loːsveːɐ̯dn̩	1
löwe	løːvə	1
löwen	løːvn	9
loyal	lojaːl	1
loyal	lo̯ajaːl	1
lübeck	lyːbɛk	1
lübeck	lyːbeːk	1
lucia	luːtsiːa	2
lucia	luːtsja	2
ludwig	luːtvɪç	3
ludwig	luːtvɪk	3
ludwig	lʊtvɪç	3
luft	lʊft	18
luftwaffe	lʊftvafə	2
lund	lʊnt	1
lunge	lʊŋə	2
lust	lʊst	9
lustig	lʊstɪç	2
lustlos	lʊstloːs	1
luther	lʊtɐ	1
luther	luːtɐ	1
lutz	lʊt͡s	1
luxemburg	lʊksəmbʊʁk	4
luzern	lutsɛʁn	3
m	ʔɛm	4
machbar	maxbaːɐ̯	2
mache	maχə	15
machen	maxən	92
macher	maxəʁ	2
macht	maχt	75
mächte	mɛçtə	1
mächtig	mɛçtɪç	3
machtlos	maxtloːs	1
mädchen	mɛːtçən	6
mädchen	meːtçən	6
madrid	madrɪt	5
madrider	madrɪdɐ	1
madrider	madrɪtɐ	1
mag	maːk	19
mag	max	19
magazin	maɡatsiːn	1
magnet	maɡneːt	1
mähne	mɛːnə	1
mahnte	maːntə	3
mahnung	maːnʊŋ	1
mai	maɪ	36
mail	mɛɪ̯l	6
mail	meːl	6
mainz	maɪnts	11
mal	maːl	110
mal	ma	110
mal	maːl	110
maler	maːlɐ	1
malheur	maløːɐ̯	1
mallorca	malɔʁka	1
mallorca	majɔʁka	1
mama	mama	2
mama	mamaː	2
man	man	369
manager	mɛnɛd͡ʒɐ	19
manager	-nə-	19
manager	-nɪ-	19
manch	manç	2
manchmal	mançmaːl	12
mandat	mandaːt	1
manfred	maːnfʁeːd	1
manipulieren	manipuliːʁən	3
männer	mɛnɐ	32
mannheim	manhaɪ̯m	5
manöver	manøːvɐ	5
manuela	manueːla	1
mappe	mapə	1
marathon	maʁatɔn	1
märchen	mɛɐ̯çn̩	1
maria	maʁiːa	6
markenzeichen	maʁkn̩t͡saɪ̯çn̩	3
markieren	maʁkiːʁən	1
markt	maʁkt	23
markt	maːkt	23
markus	maʁkʊs	10
markus	maːkʊs	10
marokko	maʁɔko	1
marsch	maʁʃ	2
marsch	maːʃ	2
marshmallow	maːʃmɛloʊ̯	1
martin	maʁtɪn	22
märz	mɛʁts	36
masche	maʃə	2
maschine	maʃiːnə	3
maschinen	maʃiːnən	4
maschinen	maʃiːnn̩	4
maske	maskə	1
masse	masə	4
masse	maːsə	4
masse	maːsə	4
massnahme	maːsnaːmə	2
massnahmen	maːsnaːmən	2
mästen	mɛstən	1
material	matʰəriaːl	5
material	matʰəjaːl	5
material	mɑtərjɑːl	5
materie	mateːʁiə	1
matratze	matʁatsə	1
matt	mat	1
mauern	maʊ̯ɐn	2
mauern	maʊ̯ɐn	2
maul	maʊ̯l	1
maus	maʊ̯s	2
maut	maʊ̯t	1
mazedonien	matsedoːniən	4
medaille	medaljə	3
medaillenspiegel	medaljənʃpiːɡəl	1
medien	meːdi̯ən	27
medienwissenschaft	meːdi̯ənvɪsn̩ʃaft	1
medium	meːdi̯ʊm	2
medizin	meditsiːn	2
mediziner	medit͡siːnɐ	3
meer	meːɐ̯	7
meerenge	meːɐ̯ʔɛŋə	1
megabyte	meːɡabaɪ̯t	1
megafon	meːɡafoːn	1
megafon	mɛɡa-	1
mehmet	mɛmɛt	1
mehmet	mɛçmɛt	1
mehr	meːɐ̯	422
mehren	meːʀən	1
mehrere	meːrərə	43
mehrere	meːɐ̯rə	43
mehrere	meːrə	43
mehrfach	meːɐ̯fax	7
mehrheit	meːɐ̯haɪ̯t	14
mehrheit	mɛɐ̯haɪ̯t	14
mehrheiten	meːɐhaɪ̯tən	1
mehrmals	meːɐ̯maːls	5
mehrwertsteuer	meːɐ̯veːɐ̯tʃtɔʏɐ	2
mehrzahl	meːɐ̯t͡saːl	2
meiden	maɪ̯dn̩	2
meiden	maɪ̯dən	2
meier	maɪ̯ɐ	7
meike	maɪ̯kə	1
meiler	maɪ̯lɐ	1
mein	maɪ̯n	28
meine	maɪ̯nə	48
meinem	maɪ̯nəm	12
meinem	maɪ̯m	12
meinen	maɪ̯nən	14
meinen	maɪ̯nən	14
meinen	maɪ̯n	14
meiner	maɪ̯nɐ	9
meines	maɪ̯nəs	1
meinungsfreiheit	maɪ̯nʊŋsfʁaɪ̯haɪ̯t	1
meist	maɪ̯st	19
meisters	maɪ̯stɐs	1
melden	mɛldən	23
meldung	mɛldʊŋ	7
melken	mɛlkən	1
memoiren	memo̯aːʀən	1
menge	mɛŋə	10
mengen	mɛŋən	2
mensch	mɛnʃ	13
mensch	mɛnʃ	13
menschenmenge	mɛnʃn̩mɛŋə	1
menschenverstand	mɛnʃn̩fɛɐ̯ʃtant	1
menschheit	mɛnʃhaɪ̯t	6
menschlich	mɛnʃlɪç	2
menschlichkeit	mɛnʃlɪçkaɪ̯t	1
mensen	mɛnzn̩	1
mensen	mɛnzən	1
merken	mɛʁkŋ̍	2
merken	mɛʁkən	2
merkmal	mɛʁkmaːl	1
messe	mɛsə	2
messe	mɛsə	2
messen	mɛsn̩	6
messen	mɛsən	6
messen	mɛsn̩	6
messen	mɛsən	6
messer	mɛsɐ	4
messie	mɛsi	1
metapher	metafɐ	1
meter	meːtɐ	24
methan	metaːn	1
methode	metoːdə	2
metropole	metʀopoːlə	3
mexiko	mɛksiko	10
mich	mɪç	82
michael	mɪçaʔeːl	26
michael	mɪçaʔɛl	26
michel	mɪçl̩	4
mies	miːs	1
miete	miːtə	1
miete	miːtə	1
mieten	miːtn̩	3
mieten	miːtən	3
mieter	miːtɐ	5
mieze	miːt͡sə	1
mikrofon	mikʀofoːn	1
milchkuh	mɪlçkuː	1
milliarde	mɪli̯aʁdə	10
milliarde	mɪljaːdə	10
million	mɪli̯oːn	6
millionen	mɪli̯oːnən	146
millionenfach	mɪli̯oːnənfaχ	1
minderjähriger	mɪndɐjɛːʁɪɡɐ	2
mindestens	mɪndəstəns	27
mine	miːnə	1
minen	miːnən	1
minimal	minimaːl	2
minister	mɪnɪstɐ	7
ministerin	minɪstəʀɪn	3
ministerium	mɪnɪsteːʁiʊm	4
minus	miːnʊs	14
minute	minuːtə	26
minuten	minuːtn̩	51
minutenlang	minuːtn̩laŋ	1
mir	miːɐ̯	85
mir	mɐ	85
mir	mə	85
mischen	mɪʃn̩	2
mischen	mɪʃən	2
mischung	mɪʃʊŋ	3
miss	mɪs	6
missachtung	mɪsaxtʊŋ	2
missbräuchlich	mɪsbʀɔɪ̯çlɪç	1
misstrauen	mɪstʁaʊ̯ən	3
misstrauen	mɪstʁaʊ̯ən	3
mist	mɪst	2
mit	mɪt	1564
mitbringen	mɪtʰbʀɪŋn̩	1
miteinander	mɪtʔaɪ̯nandɐ	6
miteinander	mɪtənandɐ	6
miteinander	mɪdənandɐ	6
miteinander	mɪtnandɐ	6
mitfahrgelegenheit	mɪtfaːɡəleːɡŋ̩haɪ̯t	1
mitgefühl	mɪtɡəfyːl	2
mitglied	mɪtɡliːt	9
mitglieder	mɪtɡliːdɐ	12
mitgliedern	mɪtɡliːdɐn	6
mitglieds	mɪtɡliːts	1
mithelfen	mɪthɛlfən	1
mithilfe	mɪthɪlfə	3
mitläufer	mɪtlɔɪ̯fɐ	1
mitleid	mɪtlaɪ̯t	1
mitnehmen	mɪtneːmən	1
mitsingen	mɪtzɪŋən	1
mittag	mɪtaːk	2
mittag	mɪtax	2
mittag	mɪtaːx	2
mitte	mɪtə	15
mitteilung	mɪttaɪ̯lʊŋ	10
mittel	mɪtəl	12
mittelfeld	mɪtəlfɛlt	2
mittelklasse	mɪtl̩klasə	2
mittelklasse	mɪtəlklasə	2
mittelpunkt	mɪtl̩pʊŋkt	6
mittelpunkt	mɪtəlpʊŋkt	6
mittels	mɪtl̩s	3
mitternacht	mɪtɐnaχt	3
mittlerweile	mɪtlɐvaɪ̯lə	23
mittwoch	mɪtvɔχ	37
mitunter	mɪtʊntɐ	2
mixen	mɪksn̩	1
mixen	mɪksən	1
möbel	møːbl̩	3
möbel	møːbəl	3
mobile	moːbilə	10
mobilisieren	mobiliziːʀən	1
mobilität	mobilitɛːt	1
möchte	mœçtʰə	27
modder	mɔdɐ	1
modell	modɛl	9
modelle	modɛlə	11
mögen	møːɡən	1
möglich	møːklɪç	64
mögliche	møːklɪçə	10
möglichkeit	møːklɪçkaɪ̯t	18
möglichkeiten	møːklɪçkaɪ̯tən	10
möglichst	møːklɪçst	12
mohammed	moːhamɛt	2
mohammed	mohamɛt	2
mohammed	mɔɐ̯mɛt	2
moldawien	mɔldaːviən	1
möller	mœlɐ	2
moment	momɛnt	11
monat	moːnat	23
monat	moːnaːt	23
monate	moːnatə	21
monatelang	moːnatəlaŋ	1
monatlich	moːnatlɪç	1
monats	moːnats	4
mond	moːnt	1
monde	moːndə	2
montag	moːntaːk	51
montag	moːntax	51
montag	moːntaːx	51
montieren	mɔntiːʁən	1
montréal	mɔntʁeaːl	2
moral	moʁaːl	3
mord	mɔrt	5
mörder	mœʁdɐ	1
morgen	mɔrɡən	15
morgen	mɔrŋ	15
morgen	mɔrjən	15
morgen	mɔrɡən	15
morgen	mɔrŋ	15
morgen	mɔrjən	15
morgens	mɔʁɡəns	6
moschee	mɔʃeː	2
moscheen	mɔʃeːən	1
moskau	mɔskau	18
motel	motɛl	1
motiv	motʰiːf	2
motivieren	motiviːʁən	1
motor	moːtoːɐ̯	4
motor	-tɔɐ̯	4
motor	moːtɐ	4
motor	motoːɐ̯	4
motorola	moːtoʁoːla	1
motorola	mɔto-	1
motorroller	moːtoːɐ̯ʁɔlɐ	1
müde	myːdə	3
mühe	myːə	2
mühlstein	myːlʃtaɪ̯n	1
mühsam	myːzaːm	1
müll	mʏl	1
müller	mʏlɐ	12
münchen	mʏnçən	42
mund	mʊnt	3
münster	mʏnstɐ	6
munter	mʊntɐ	1
museen	muzeːən	2
museum	muzeːʊm	5
museum	das‿muzeːʊm	5
musik	muziːk	15
musik	mʊzɪk	15
musik	moːziːk	15
musiker	muːzikɐ	2
muslim	mʊslɪm	1
muslim	mʊsliːm	1
muslimas	mʊsliːmas	1
muslimas	mʊslɪmas	1
muss	mʊs	154
muss	mʊs	154
müsse	mʏsə	37
müssen	mʏsən	106
müsst	mʏst	1
musste	mʊstə	40
müsste	mʏstə	15
mussten	mʊstn̩	26
mussten	mʊstən	26
müssten	mʏstn̩	20
müssten	mʏstən	20
muster	mʊstɐ	5
mustern	mʊstɐn	1
mustern	mʊstɐn	1
mut	muːt	4
mutig	muːtɪç	1
mutter	mʊtɐ	19
mutter	mʊtɐ	19
mütter	mʏtɐ	3
mutterland	mʊtɐlant	1
mütterlich	mʏtɐlɪç	1
muttersprache	mʊtɐʃpʁaːxə	1
mythos	myːtɔs	1
na	naː	1
na	na	1
nach	naːx	654
nach	nax	654
nachbar	naxbaːɐ̯	3
nachbarn	naχbaːɐ̯n	3
nachbarschaft	naxbaːɐ̯ʃaft	2
nachbörslich	naːχbœʁslɪç	1
nachdenken	naːxdɛŋkŋ̩	3
nachdenken	naːxdɛŋkən	3
nachdruck	naːχdʁʊk	3
nachfolger	naːχfɔlɡɐ	10
nachgefragt	naːχɡəfʀaːkt	1
nachhaltigkeit	naːχhaltɪçkaɪ̯t	5
nachher	naːxheːɐ̯	1
nachher	naːxheːɐ̯	1
nachher	naːxɐ	1
nachher	nahɛɐ̯	1
nachkommen	naːxkɔmən	1
nachkriegszeit	naːxkʁiːkstsaɪ̯t	1
nachmittag	naːxmɪtaːk	8
nachmittag	naxmɪtax	8
nachmittags	naːxmɪtaːks	3
nachmittags	naxmɪtaxs	3
nachmittags	namətaxs	3
nachricht	naːxʁɪçt	18
nachrichten	naːxʁɪçtən	26
nachrichtenagentur	naːχʁɪçtənaɡɛntuːɐ	7
nachschlagen	naːxʃlaːɡŋ̩	1
nachschlagen	naːxʃlaːɡən	1
nachsehen	naːxzeːən	1
nachspielzeit	naːxʃpiltsaɪ̯t	3
nächster	nɛːstɐ	8
nächster	neːstɐ	8
nächster	nɛːçstɐ	8
nächster	nɛːkstɐ	8
nächster	nɛkstɐ	8
nächster	nɛːkstər	8
nächster	nɛkstər	8
nächster	nɛːxstər	8
nacht	naxt	23
nächte	nɛçtə	1
nachteil	naːxtai̯l	1
nachvollziehbar	naːχfɔltsiːbaːʁ	1
nachvollziehen	naːχfɔlt͡siːən	3
nachweis	naːχvaɪ̯s	2
nachwuchs	naːxvuːks	8
nagel	naːɡl̩	2
nagel	naːɡəl	2
nagel	naːɡl̩	2
nah	naː	3
nahe	naːə	16
nähe	nɛːə	12
näher	nɛːɐ	8
naht	naːt	1
naiv	naʔiːf	2
naja	naːjaː	2
name	naːmə	15
namen	naːmən	23
namentlich	naːməntlɪç	1
namibia	namiːbia	1
nämlich	nɛːmlɪç	22
nase	naːzə	6
nass	nas	1
nation	nat͡si̯oːn	7
national	natsi̯onaːl	6
national	natsi̯onaːl	6
nationalismus	natsi̯onalɪsmʊs	1
nationalsozialismus	natsi̯onaːlzotsi̯alɪsmʊs	1
nationalsozialisten	natsi̯onaːlzotsi̯alɪstn̩	1
nationalsozialisten	natsi̯onaːlzotsi̯alɪstən	1
nationen	natsi̯oːnən	4
natürlich	natyːʁlɪç	54
navi	navi	2
navi	naːvi	2
nazis	naːtsiːs	3
ne	nə	3
ne	neː	3
ne	nə	3
neapel	neaːpl̩	2
neben	neːbm̩	52
neben	neːbən	52
nebenan	neːbm̩an	2
nebensache	neːbn̩zaxə	2
nebst	neːpst	1
neffe	nɛfə	1
negativ	neːɡatiːf	5
negativ	nɛɡɐtiːf	5
neger	neːɡɐ	2
neger	neːɡər	2
nehmen	neːmən	34
neid	naɪ̯t	1
neidisch	naɪ̯dɪʃ	1
nein	naɪ̯n	14
nennen	nɛnən	4
nepal	neːpal	3
nerven	nɛʁfən	3
nerven	nɛʁvən	3
nervenstärke	nɛʁfənʃtɛʁkə	1
net	nɛt	1
net	nət	1
netflix	ɪnstəɡrɛm	6
neu	nɔʏ̯	46
neuauflage	nɔɪaʊflaːɡə	1
neudeutsch	nɔɪ̯dɔɪ̯t͡ʃ	1
neuerdings	nɔɪ̯ɐdɪŋs	3
neuerung	nɔɪ̯əʀʊŋ	4
neuerungen	nɔɪ̯əʀʊŋən	5
neugierig	nɔʏ̯ɡiːʁɪç	1
neulich	nɔɪ̯lɪç	1
neun	nɔʏ̯n	12
neuseeland	nɔɪzeːlant	2
neuseeländer	nɔɪzeːlɛndɐ	2
neutral	nɔɪ̯tʀaːl	2
nevada	nevaːda	1
nicht	nɪçt	1233
nicht	nɪç	1233
nichte	nɪçtə	2
nichts	nɪçts	73
nichts	nixts	73
nick	nɪk	2
nie	niː	52
niedergang	niːdɐɡaŋ	1
niederlande	niːdɐlandə	5
niederländerin	niːdɐlɛndɐʁɪn	1
niederlassung	niːdɐlasʊŋ	1
niederlassungen	niːdɐlasʊŋən	2
niedrig	niːdʀɪç	4
niemals	niːmaːls	7
niemand	niːmant	23
nigeria	niɡeːʁia	3
nils	niːls	1
niveau	nivoː	14
nix	nɪks	2
nix	nɪks	2
noch	nɔx	510
noch	nɔ	510
noch	no	510
nochmal	nɔχmaːl	4
nochmals	nɔχmaːls	6
nokia	noːki̯a	3
nominal	nominaːl	1
nord	nɔʁt	1
norden	nɔʁdn	4
nordirland	nɔʁtɪʁlant	1
nordöstlich	nɔʁtʔœstlɪç	1
normal	nɔʁmaːl	2
normalerweise	nɔʁmaːlɐvaɪ̯zə	4
norweger	nɔʁveːɡəʁ	2
not	noːt	7
notebook	noːtbʊk	2
notebook	nɔʊ̯t-	2
noten	noːtn̩	1
notfall	noːtfal	3
nötig	nøːtɪç	16
nötigung	nøːtɪɡʊŋ	1
notiz	notiːts	1
notiz	notɪts	1
notstand	noːtʃtant	1
notwehr	noːtveːɐ̯	1
notwendig	noːtvɛndɪç	11
notwendig	noːtvɛndɪk	11
notwendigkeit	noːtvɛndɪçkaɪ̯t	3
november	novɛmbɐ	35
nu	nuː	1
nüchtern	nʏçtɐn	1
nudeln	nuːdl̩n	1
nudeln	nuːdəln	1
null	nʊl	4
nummer	nʊmɐ	15
nun	nuːn	169
nunmehr	nuːnmeːɐ̯	5
nur	nuːɐ̯	436
nutzen	nʊtsən	32
nützen	nʏtsən	1
nützlich	nʏtslɪç	2
nutzung	nʊtsʊŋ	15
ob	ɔp	100
ob	ɔp	100
ob	oːp	100
oberhausen	oːbɐhaʊzən	1
oberschenkel	oːbɐʃɛŋkl̩	1
objektiv	ɔpjɛktiːf	1
objektiv	ɔpjɛktiːf	1
obschon	ɔpʃoːn	2
obst	oːpst	2
obwohl	ɔpvoːl	24
oder	ʔoːdɐ	411
offen	ʔɔfɱ̩	24
offen	ʔɔfən	24
offenbar	ɔfn̩baːɐ̯	33
offenbar	ɔfn̩baːɐ̯	33
offensichtlich	ʔɔfənzɪçtlɪç	14
offensichtlich	ʔɔfənzɪçtlɪç	14
offensiv	ɔfɛnziːf	2
offensiv	ɔfɛnziːf	2
offensiv	ɔfn̩ziːf	2
offensiv	ɔfn̩ziːf	2
offiziell	ɔfitsjɛl	15
öffnen	ʔœfnən	7
öffnung	œfnʊŋ	3
oft	ɔft	50
oh	oː	3
ohne	oːnə	138
ohnedies	oːnədiːs	1
ohnehin	oːnəhɪn	16
ohnmacht	oːnmaχt	1
ohnmächtig	oːnmɛçtɪç	2
ohr	oːr	1
ohren	oːʀən	2
okay	okeː	3
okay	okɛɪ̯	3
ökologie	økoloɡiː	1
ökosystem	øːkozʏsteːm	1
oktober	ɔktoːbɐ	35
oktoberfest	ɔktoːbɐfɛst	1
öl	øːl	4
onkel	ɔŋkəl	2
opa	oːpa	1
opa	ɔpa	1
opa	oːpʰɐ	1
oper	di‿oːpɐ	1
operation	ɔpəʀat͡sioːn	4
operieren	opəʀiːʀən	1
opfer	ɔpfɐ	23
opfer	ʔɔpfɐ	23
opfern	ʔɔpfɐn	3
opfern	ʔɔpfɐn	3
opposition	ɔpozitsjoːn	6
optimal	ɔptimaːl	7
option	ɔptsi̯oːn	10
optional	ɔptsɪ̯onaːl	1
optionen	ɔptsi̯oːnən	5
optisch	ɔptɪʃ	5
orange	orãːʃ	3
orange	oraŋʃ	3
orange	orɔ̃ːʃ	3
orange	orɔŋʃ	3
orange	orãːʒə	3
orange	oraŋʒə	3
orange	orɔ̃ːʒə	3
orange	orɔŋʒə	3
orange	orãːʒə	3
orange	oraŋʒə	3
orange	orɔ̃ːʒə	3
orange	orɔŋʒə	3
orange	orãːʃə	3
orange	oraŋʃə	3
orange	orɔ̃ːʃə	3
orange	orɔŋʃə	3
orange	orãːʃ	3
orange	oraŋʃ	3
orange	orɔ̃ːʃ	3
orange	orɔŋʃ	3
orden	ɔʁdn̩	1
ordentlich	ɔʁdəntlɪç	6
ordnen	ɔʁdnən	1
ordnung	ʔoʁdnʊŋ	5
ordnung	ʔoʁnʊŋ	5
organ	oʁɡaːn	1
organisieren	ɔʀɡaniziːʀən	2
orientieren	oʁiɛntiːʁən	2
orientiert	oʀi̯ɛntiːɐ̯t	2
original	oʁiɡinaːl	2
ort	ɔrt	29
ortsteil	ɔʁt͡staɪ̯l	2
ost	ɔst	4
osten	ɔstən	15
osten	ɔstn̩	15
österreich	øːstəʁaɪç	32
österreicher	øːstəʁaɪçɐ	9
österreicherin	øːstəʁaɪçəʁɪn	2
osteuropa	ɔstɔɪʁoːpa	1
out	aʊ̯t	1
ozean	ʔoːtseaːn	1
ozeans	ʔoːtseaːns	1
p	peː	1
paar	paːɐ̯	32
paar	paːɐ̯	32
paar	paːr	32
päckchen	pɛkçən	1
paderborn	paːdərbɔrn	2
paket	pakeːt	3
pakistan	paːkɪstaːn	5
pakt	pakt	1
paläontologie	palɛɔntoloɡiː	1
panzer	pantsɐ	2
panzer	pantsər	2
papa	papa	2
papa	papaː	2
papier	papiːɐ̯	14
papiere	papiːʀə	4
paprika	paprika	1
paprika	paprɪka	1
papst	paːpst	10
paradoxon	paʁaːdɔksɔn	1
paradoxon	paʁadɔksɔn	1
parameter	paʀaːmetɐ	1
parat	paʀaːt	1
paris	paʁiːs	20
park	paʁk	5
park	paːk	5
parken	paʁkən	1
parken	paːkən	1
parkplatz	parkplat͡s	4
parlament	paʁlamɛnt	19
parlamentarier	paʁlamɛntaːʀi̯ɐ	3
part	part	1
partei	paʁtaɪ̯	24
partie	paʁtiː	15
pass	pas	5
pässe	pɛsə	1
passen	pasən	5
passieren	pasiːren	12
passiert	pasiːɐ̯t	14
passus	pasʊs	1
passwort	pasvɔʁt	6
pastor	pastɔɐ̯	1
pastor	pastoːɐ̯	1
pastorin	pastoːʁɪn	1
pater	paːtɐ	1
paternalistisch	patɛʁnalɪstɪʃ	1
patient	pat͡si̯ɛnt	1
patienten	patsi̯ɛntən	16
patriarch	patʁiaʁç	1
patriarch	patʁiaːç	1
paul	paʊ̯l	7
pause	paʊ̯zə	7
pausen	paʊ̯zən	1
pavillon	pavɪljɔŋ	1
pavillon	-jɔ̃ː	1
pavillon	pavəljɔŋ	1
pavillon	pavijɔ̃ː	1
pavillon	pavɪljoːn	1
pazifismus	patsifɪsmʊs	1
pech	pɛç	1
pedal	pedaːl	1
pegel	peːɡl̩	1
peinlich	paɪ̯nlɪç	2
peitschen	paɪ̯tʃən	1
peking	peːkɪŋ	10
pension	pãzi̯oːn	2
pension	pãsi̯oːn	2
pension	paŋzi̯oːn	2
pension	pɛnzi̯oːn	2
pentagon	pɛntaɡɔn	1
pentagon	pɛntaɡoːn	1
permanent	pɛʁmanɛnt	2
person	pɛʁzoːn	14
person	pɛrzoːn	14
persönlich	pɛʁzøːnlɪç	8
persönlichkeit	pɛʁzøːnlɪçkaɪ̯t	1
persönlichkeiten	pɛʁzøːnlɪçkaɪ̯tən	2
perspektive	pɛʁspɛktiːvə	4
peru	peʁuː	1
pest	pɛst	1
peter	peːtɐ	20
petra	peːtʀa	1
pfand	pfant	1
pfand	fant	1
pfeifen	pfaɪ̯fən	1
pfeifen	faɪ̯fən	1
pfeil	pfaɪ̯l	1
pfeil	faɪ̯l	1
pfeilschnell	pfaɪ̯lʃnɛl	1
pferd	pfeːrt	3
pferd	pfeːɐ̯t	3
pferde	pfeːɐ̯də	4
pfiff	pfɪf	1
pfiff	fɪf	1
pflanze	pflantsə	1
pflanze	flantsə	1
pflanze	pflantsə	1
pflanzen	pflantsn̩	4
pflanzen	pflantsən	4
pflege	pfleːɡə	3
pflege	fleːɡə	3
pflegen	pfleːɡən	2
pflegen	fleːɡən	2
pfleger	pfleːɡɐ	1
pflicht	pflɪçt	3
pflicht	flɪçt	3
pfosten	pfɔstən	1
pfosten	fɔstən	1
pfote	pfoːtə	1
pfote	foːtə	1
pfund	pfʊnt	2
pfund	fʊnt	2
phänomen	fɛnomeːn	3
phase	faːzə	2
phasen	faːzn̩	2
phasen	faːzən	2
philosoph	filozoːf	1
philosophie	filozofiː	1
physiker	fyːzikɐ	1
piano	piaːno	2
pietätlos	piːətɛːtloːs	1
pille	pɪlə	1
pilot	piloːt	1
pistole	pɪstoːlə	3
pizza	pɪtsa	3
pizza	pɪtsɐ	3
pkw	peːkaveː	4
pkw	peːkaveː	4
pkw	peːkaveː	4
plan	plaːn	8
planen	plaːnən	4
planet	planeːt	1
planeten	planeːtn	5
platz	plat͡s	71
platz	plats	71
plätzchen	plɛt͡sçən	2
platze	platsə	1
platze	platsə	1
plätze	plɛtsə	10
platzen	platsən	1
plätzen	plɛtsn̩	3
plätzen	plɛtsən	3
platzieren	platsiːɐ̯n	1
platzieren	platsiːrən	1
pleite	plaɪ̯tə	5
plötze	plœt͡sə	2
plötzlich	plœt͡slɪç	12
pluto	pluːtoː	1
pokal	pokaːl	4
polar	polaːɐ̯	1
polen	poːlən	11
politiker	poliːtikɐ	16
politisch	poliːtɪʃ	4
politologin	politoloːɡɪn	1
polizei	polit͡saɪ̯	72
polizeiwache	polit͡saɪ̯vaχə	2
polizist	polit͡sɪst	5
polizisten	polit͡sɪstən	19
pommern	pɔmɐn	1
portal	pɔʁtaːl	6
portemonnaie	pɔʁtmoneː	1
portemonnaie	pɔʁt-	1
portemonnaie	-mɔ-	1
porto	pɔʁto	2
porträt	pɔrtrɛː	1
positiv	poːzitiːf	12
positiv	pɔzɪtiːf	12
positives	poːzitiːvəs	1
post	pɔst	10
posten	poːstn̩	8
posten	poːstən	8
postfach	pɔstfaχ	1
postleitzahl	pɔstlaɪ̯ttsaːl	2
potenzial	potɛntsi̯aːl	8
praktikabel	pʀaktikaːbl̩	1
prämiert	pʀɛmiːɐ̯t	1
prärie	pʀɛʀiː	1
präsent	pʁɛzɛnt	2
präsident	pʁɛzidɛnt	26
prävention	pʁɛvɛnt͡si̯oːn	2
praxis	pʁaksɪs	8
preis	pʁaɪ̯s	30
premierminister	pʁemjeːminɪstɐ	4
presse	pʀɛsə	6
pressemitteilung	pʁɛsəmɪtaɪlʊŋ	2
prinz	pʀɪnt͡s	4
prinzip	pʁɪntsiːp	8
prinzip	pʁɪntsɪp	8
prinzipiell	pʁɪntsipi̯ɛl	1
prinzipien	pʀɪntsiːpi̯ən	2
privat	pʀivaːt	3
probleme	pʀobleːmə	31
problems	pʀobleːms	4
produzieren	pʀodutsiːʀən	3
professor	pʁofɛsoːɐ̯	3
professorin	pʁofɛsoːʁɪn	1
profit	pʁofiːt	2
profit	pʁofɪt	2
profitieren	pʁofitiːʁən	15
prognose	pʀoɡnoːzə	8
programm	proɡram	14
programme	pʀoɡʀamə	8
programmieren	pʀoɡʀamiːʀən	1
programmierung	pʀoɡʀamiːʀʊŋ	1
projekt	pʁojɛkt	22
promi	pʁɔmi	1
propagandistisch	pʀopaɡandɪstɪʃ	1
prophet	pʀofeːt	1
protagonisten	pʀotaɡonɪstn̩	2
protagonisten	pʀotaɡonɪstən	2
protest	pʁotɛst	3
protestieren	pʁotɛstiːʁən	3
provisorium	pʁovizoːʁiʊm	1
prozentual	pʀot͡sɛntu̯aːl	1
prüfen	pʀyːfən	8
pseudonym	psɔɪ̯dɔnyːm	1
publikation	publikat͡si̯oːn	1
publikum	puːbliːkʊm	14
pulk	pʊlk	1
pullover	pʊloːvɐ	1
pult	pʊlt	1
pumpe	pʊmpə	1
pumpen	pʊmpən	1
punk	paŋk	1
punkt	pʊŋkt	10
pur	puːɐ̯	1
pürieren	pyriːrən	1
pürieren	pʰyriːɐ̯n	1
purismus	puʁɪsmʊs	1
putz	pʊt͡s	1
putzen	pʊtsən	2
putzfrau	pʊt͡sfʁaʊ̯	2
q	kuː	1
qual	kvaːl	1
quälen	kvɛːlən	1
quälen	kveːlən	1
qualifizieren	kvalifitsiːʁən	2
qualität	kvalitɛːt	16
qualität	kvaliteːt	16
quartal	kvartaːl	22
quartal	kvətaːl	22
quartett	kvaʁtɛt	1
quartier	kvaʁtiːɐ̯	2
quelle	kvɛlə	12
quellen	kvɛln̩	8
quellen	kvɛlən	8
quer	kveːɐ̯	1
quick	kvɪk	2
quittung	kvɪtʊŋ	1
r	ʔɛɐ̯	1
rabatt	ʁabat	3
rache	raxə	3
rad	raːt	1
rad	rat	1
radeln	ʀaːdl̩n	1
radio	ʀaːdɪ̯o	6
raffen	ʁafn̩	1
rage	ʀaːʒə	1
ragen	ʁaːɡən	1
rahmen	ʁaːmən	24
rakete	ʀakeːtə	1
rande	ʁandə	3
rang	ʀaŋ	16
rang	ʁaŋ	16
rangelei	ʁaŋəlaɪ̯	1
rasen	raːzən	5
rasen	ʁaːzən	5
raserei	ʁaːzəʁaɪ̯	1
rassisten	ʀasɪstn̩	1
rassisten	ʀasɪstən	1
rast	ʀaːst	1
rast	ʀast	1
rast	ʁast	1
rat	ʀaːt	5
rate	ʀaːtə	4
raten	ʀaːtn̩	3
raten	ʀaːtən	3
raten	ʀaːtn̩	3
raten	ʀaːtən	3
rates	ʀaːtəs	2
ratsam	ʁaːtzaːm	1
ratte	ʁatə	1
rau	ʁaʊ̯	1
räuber	ʀɔʏ̯bɐ	2
raufusskauz	ʁaʊfuːskaʊts	1
raum	ʁaʊ̯m	13
räume	ʀɔɪ̯mə	1
räumen	ʀɔɪ̯mən	4
räumen	ʀɔɪ̯mən	4
raumes	ʀaʊ̯məs	1
räumte	ʁɔʏ̯mtə	1
raus	ʀaʊ̯s	6
rausch	ʀaʊ̯ʃ	1
rauschen	ʁaʊ̯ʃən	1
reagieren	ʁeaɡiːʁən	13
real	ʁeal	12
real	ʀeaːl	12
realisierbar	ʀealiziːɐ̯baːɐ̯	1
realisieren	ʁeːaliziːʁən	5
realität	ʁea̯litɛːt	5
realitäten	ʁea̯litɛːtən	1
realitätsfremd	ʀealitɛːtsfʀɛmt	1
rebellen	ʀebɛlən	3
rechnen	ʀɛçnən	14
rechner	ʀɛçnɐ	7
rechnung	ʀɛçnʊŋ	8
rechnungen	ʀɛçnʊŋən	3
recht	ʁɛçt	39
recht	rɛçt	39
recht	ʁɛçt	39
rechten	ʀɛçtn̩	7
rechten	ʀɛçtən	7
rechten	ʁɛçtn̩	7
rechtfertigen	ʁɛçtfɛʁtiɡən	3
rechts	ʁɛçt͡s	9
rechtsanwalt	ʀɛçt͡sʔanvalt	2
rechtskräftig	ʀɛçt͡skʀɛftɪç	1
reck	ʁɛk	1
rede	reːdə	10
reden	ʁeːdən	10
reduzieren	ʀedut͡siːʀən	4
referendum	ʁɛfəʁɛndʊm	6
referendum	ʁeːfə-	6
reform	ʀefɔʁm	3
regal	ʁeɡaːl	2
regelmässig	ʁeːɡl̩mɛːsɪç	3
regeln	ʀeːɡl̩n	16
regeln	ʀeːɡl̩n	16
regeln	ʀeːɡəln	16
regen	ʁeːɡən	8
regenguss	ʀeːɡn̩ɡʊs	1
regenwald	ʀeːɡn̩valt	1
regenwetter	ʀeːɡn̩vɛtɐ	1
regierungsrat	ʁəɡiːʁʊŋsʀaːt	2
regime	ʁeʒiːm	3
regime	ʁeʒiːmə	3
registrieren	ʁeɡɪstʁiːʁən	4
reglos	ʀeːkloːs	1
regnerisch	ʀeːɡnəʀɪʃ	1
regulierung	ʁeɡuliːʁʊŋ	1
reibungslos	ʁaɪ̯bʊŋsloːs	2
reiche	ʀaɪ̯çə	4
reichen	ʀaɪ̯çn̩	6
reichen	ʀaɪ̯çən	6
reicher	ʀaɪ̯çɐ	1
reichlich	ʁaɪ̯çlɪç	7
reichs	ʀaɪ̯çs	1
reichsten	ʀaɪ̯çstn̩	3
reichsten	ʀaɪ̯çstən	3
reichtum	ʀaɪ̯çtuːm	3
reichweite	ʀaɪ̯çvaɪ̯tə	4
reifen	ʀaɪ̯fn̩	6
reifen	ʁaɪ̯fn̩	6
reifen	ʁaɪ̯fən	6
reihe	ʀaɪ̯ə	9
reihen	ʀaɪ̯ən	1
reihen	ʀaɪ̯ɘn	1
reihen	ʀaɪ̯n	1
reihenfolge	ʀaɪ̯ənfɔlɡə	1
reim	ʁaɪ̯m	1
rein	ʁaɪn	6
reinerbig	ʀaɪ̯nʔɛʁbɪç	1
reinigen	ʁaɪ̯niɡən	1
reinigung	ʁaɪ̯niɡʊŋ	1
reis	ʀaɪ̯s	2
reis	ʀɛɪ̯s	2
reissen	ʀaɪ̯sn̩	1
reissen	ʀaɪ̯sən	1
reiten	ʁaɪ̯tən	2
reiten	ʁaɪ̯tən	2
reiter	ʀaɪ̯tɐ	1
rekord	ʁekɔʁt	1
rekorde	ʁekɔʁdə	2
rektor	ʁɛktoɐ	2
relegation	ʁeːleɡatsjoːn	1
relegation	ʁɛ-	1
relegation	-lə-	1
religion	reliɡjoːn	5
remis	ʀəmiː	1
remis	ʀəmiː	1
rendite	ʁɛndiːtə	3
renten	ʀɛntn̩	1
renten	ʀɛntən	1
reparieren	ʀepaʀiːʀən	3
reportage	repɔrtaːʒə	2
reporter	ʁepɔʁtəʁ	3
repräsentativ	ʀepʀɛzɛntatiːf	1
resigniert	ʀezɪɡniːɐ̯t	1
respektive	respɛktiːve	2
rest	ʁɛst	10
restaurant	ʁɛstoʁãː	7
restaurant	-ʁaŋ	7
restaurant	-ʁɔŋ	7
restaurieren	ʁestaʊ̯ʁiːʁən	1
resultat	ʁezʊltaːt	4
retten	ʀɛtn̩	4
retter	ʁɛtɐ	2
rettung	ʁɛtʊŋ	3
reumütig	ʀɔɪ̯myːtɪç	1
reuters	ʁɔʏtɐs	10
revanche	revãːʃə	2
revolte	ʁevɔltə	1
revolution	ʁeːvolutsi̯oːn	2
revolution	ʁɛvolʊtsi̯oːn	2
revolution	ʁɛvlʊtsi̯oːn	2
rhythmik	ʁʏtmɪk	1
riad	ʁiːat	3
riad	ʁijaːt	3
richard	ʁɪçaɐ̯t	4
richard	rɪçart	4
richter	ʀɪçtɐ	10
richtig	ʀɪçtɪç	31
richtung	ʁɪçtʊŋ	27
rief	ʀiːf	2
riegel	riːɡəl	1
riemen	ʁiːmən	1
riese	ʁiːzə	2
riesen	ʁiːzn̩	1
rigoros	ʀiɡoʀoːs	1
rind	ʁɪnt	1
rinder	ʁɪndɐ	1
ring	ʀɪŋ	1
ringen	ʁɪŋən	4
ringen	ʀɪŋən	4
risiko	ʁiːziko	12
risiko	ʁɪziko	12
riskieren	ʀɪskiːʀən	1
ritter	ʁɪtɐ	1
robben	rɔbən	2
robert	ʁoːbɛʁt	14
robert	ʁoːbɐt	14
roboter	ʁɔbɔtɐ	5
roboter	ʁoːbɔtɐ	5
roboter	ʁobɔtɐ	5
rock	ʁɔk	5
rock	ʁɔk	5
rock	ɹɔk	5
rolle	ʁɔlə	26
rollen	ʀɔlən	6
rollen	ʀɔlən	6
rollstuhls	ʀɔlʃtuːls	1
rom	ʁoːm	4
rom	ʁɔm	4
rom	ʁoːm	4
roma	roːma	2
roman	ʀomaːn	9
römer	røːmɐ	2
römer	røːmər	2
rosa	ʁoːza	2
rosa	ʀoːza	2
rose	ʀoːzə	2
rosten	ʁɔstən	1
rot	roːt	2
rote	ʀoːtə	5
roten	ʀoːtn̩	13
roten	ʀoːtən	13
route	ʁuːtə	3
rübe	ryːbə	1
rückblickend	ʁʏkblɪkənt	1
ruckeln	ʀʊkl̩n	1
ruckeln	ʀʊkəln	1
ruckeln	ʀʊkl̩n	1
ruckeln	ʀʊkəln	1
rücken	ʁʏkn̩	10
rücken	ʁʏkən	10
rückgang	ʁʏkɡaŋ	3
rückgrat	ʁʏkɡʁaːt	1
rückkehr	rʏkkeːɐ̯	6
rücklage	ʁʏklaːɡə	1
rückläufig	ʁʏklɔʏ̯fɪç	1
rückmeldung	ʁʏkmɛldʊŋ	1
rucksack	ʀʊkzak	1
rückschau	ʁʏkʃaʊ̯	1
rückschlag	ʁʏkʃlaːk	3
rückseite	ʁʏksaɪ̯tə	3
rücksicht	ʀʏkzɪçt	1
rücktritt	ʁʏktʁɪt	5
rückwärts	ʁʏkvɛʁts	1
rückwirkend	ʁʏkvɪʁkənt	2
rückzug	ʁyktsuːk	1
rudel	ʁuːdl̩	1
ruderer	ʀuːdəʀɐ	1
rufen	ʀuːfən	4
ruft	ʀuːft	8
rüge	ʀyːɡə	1
rügen	ʀyːɡŋ̩	1
rügen	ʀyːɡən	1
rügen	ʁyːɡən	1
ruhe	ʁuːə	11
ruhetag	ʀuːətaːk	1
ruhig	ʁuːɪç	2
ruhig	ʁʊɪ̯ç	2
rühren	ryːrən	2
rum	ʁʊm	1
rumäne	ʀumɛːnə	1
rumänien	ʁumɛːniən	2
rumänien	ʁumeːniən	2
rund	rʊnt	135
rund	ʀʊnt	135
runden	ʁʊndən	8
rundes	ʁʊndəs	2
runter	rʊntɐ	2
runter	rʊntər	2
runterkippen	ʁʊntɐkɪpən	1
runterwürgen	rʊntɐvʏrɡn̩	1
russland	ʁʊslant	49
rüsten	ʁʏstən	1
s	ʔɛs	3
saales	zaːləs	1
saarbrücken	zaːɐ̯bʁʏkən	3
sabine	zabinə	1
sache	zaxə	8
sachen	zaxn̩	13
sachgerecht	zaxɡəʁɛçt	1
sachverhalt	zaxfɛɐ̯halt	2
sack	zak	1
sackgasse	zakɡasə	2
safari	zafaːri	1
sag	zaːk	1
sag	zax	1
sage	zaːɡə	8
sage	zaːɡə	8
sagen	zaːɡən	34
sagen	zaːɡŋ̩	34
sagt	zaːkt	96
sagt	zaxt	96
sagte	zaːktə	195
sagte	zaxtə	195
sagten	zaːktn̩	3
sagten	zaːktən	3
sah	zaː	12
sahen	zaːən	4
saison	zɛzõː	40
saison	zɛzɔŋ	40
saison	zɛzoːn	40
sakko	zako	1
salat	zalaːt	2
salat	salaːt	2
salz	zalts	2
salzgitter	zalt͡sɡɪtɐ	1
samen	zaːmən	1
samenspender	zaːmənʃpɛndɐ	1
sammeln	zaml̩n	5
sammeln	zaməln	5
sammler	zamlɐ	1
sammlung	zamlʊŋ	3
samstag	zamstʰaːk	48
samstag	zamstʰax	48
samstag	zamstʰaːx	48
samstag	samʃtʰaːk	48
samsung	zamzʊŋ	17
samt	zamt	4
samt	samt	4
sand	zant	2
sang	zaŋ	1
sänger	zɛŋɐ	3
sänger	sɛŋɐ	3
sänger	sɛŋər	3
sängerin	zɛŋɡəʁɪn	1
saniert	zaniːɐ̯t	1
sarg	zark	1
sarg	zaːç	1
sass	zaːs	1
satire	zatiːʁə	2
sattel	zatl̩	1
satz	zat͡s	6
sauber	zaʊ̯bɐ	4
säuberlich	zɔɪ̯bɐlɪç	1
sauerstoff	zaʊ̯ɐʃtɔf	2
säule	zɔʏ̯lə	1
säulen	zɔɪ̯ln̩	2
säulen	zɔɪ̯lən	2
scannen	skɛnən	2
scanner	skɛnɐ	2
schad	ʃaːt	1
schade	ʃaːdə	5
schade	ʃaːdə	5
schaden	ʃaːdn̩	20
schaden	ʃɑːdən	20
schädlich	ʃɛːtlɪç	3
schäfer	ʃeːfɐ	3
schäfer	ʃɛːfɐ	3
schalten	ʃaltən	2
scham	ʃaːm	1
schanghai	ʃaŋhaɪ̯	2
schar	ʃaːɐ̯	1
scharf	ʃarf	1
schärfe	ʃɛʁfə	1
scharia	ʃaʁiːa	1
schatten	ʃatən	3
schatz	ʃat͡s	2
schätzen	ʃɛtsn̩	2
schätzung	ʃɛtsʊŋ	2
schau	ʃaʊ̯	1
schauen	ʃaʊ̯ən	8
schauer	ʃaʊ̯ɐ	1
scheibe	ʃaɪ̯bə	1
schein	ʃaɪ̯n	1
scheinbar	ʃaɪ̯nbaːɐ̯	7
scheinen	ʃaɪnən	3
scheitern	ʃaɪ̯tɐn	2
scheitern	ʃaɪ̯tɐn	2
schenken	ʃɛŋkən	1
schere	ʃeːʁə	1
scherz	ʃɛʁt͡s	1
schicht	ʃɪçt	1
schick	ʃɪk	1
schicken	ʃɪkŋ̩	3
schicken	ʃɪkən	3
schicker	ʃɪkɐ	2
schickeria	ʃɪkəʁiːa	1
schicksal	ʃɪkzaːl	3
schicksal	ʃɪksaːl	3
schieben	ʃiːbən	2
schied	ʃiːt	1
schief	ʃiːf	1
schief	ʃiːf-	1
schief	ʃiːv-	1
schiefer	ʃiːfɐ	1
schiefer	ʃiːfɐ	1
schiefer	ʃiːvɐ	1
schieflage	ʃiːflaːɡə	2
schien	ʃiːn	6
schienbein	ʃiːnbaɪ̯n	1
schiene	ʃiːnə	2
schienen	ʃiːnən	3
schier	ʃiːɐ̯	2
schiessen	ʃiːsn̩	1
schiessen	ʃiːsən	1
schiff	ʃɪf	4
schiffe	ʃɪfə	1
schild	ʃɪlt	2
schimpfwort	ʃɪmpfvɔʁt	1
schiss	ʃɪs	1
schlacht	ʃlaχt	1
schlafe	ʃlaːfə	1
schlafe	ʃlaːfə	1
schlag	ʃlaːk	6
schlag	ʃlax	6
schlag	ʃlaːx	6
schlag	ʃlaːk	6
schlagen	ʃlaːɡən	2
schläger	ʃlɛːɡɐ	2
schlagfertig	ʃlaːkfɛʁtɪç	1
schlägt	ʃlɛːkt	8
schlägt	ʃleːçt	8
schlägt	ʃlɛːçt	8
schlagwort	ʃlaːkvɔʁt	1
schlagworte	ʃlaːkvɔʁtə	2
schlagzeuger	ʃlaːkt͡sɔɪ̯ɡɐ	1
schlange	ʃlaŋə	2
schlangen	ʃlaŋən	3
schlau	ʃlaʊ̯	1
schlecht	ʃlɛçt	11
schlechter	ʃlɛçtɐ	6
schleiereule	ʃlaɪ̯ɐʔɔʏ̯lə	1
schlepper	ʃlɛpɐ	3
schlesien	ʃleːzi̯ən	1
schleuser	ʃlɔʏ̯zər	2
schleuser	ʃlɔʏ̯zɐ	2
schlicht	ʃlɪçt	6
schlichter	ʃlɪçtɐ	3
schlichtheit	ʃlɪçthaɪ̯t	1
schlief	ʃliːf	1
schliesslich	ʃliːslɪç	4
schlimm	ʃlɪm	2
schloss	ʃlɔs	9
schlucht	ʃlʊχt	1
schlucken	ʃlʊkən	2
schlumpf	ʃlʊmpf	1
schlussantrag	ʃlʊsantʀaːk	1
schlüssel	ʃlʏsl̩	4
schlüssel	ʃlʏsəl	4
schlüssels	ʃlʏsl̩s	1
schlüssels	ʃlʏsəls	1
schmälern	ʃmɛːlɐn	1
schmelzen	ʃmɛltsn̩	1
schmelzen	ʃmɛltsən	1
schmelzen	ʃmɛltsn̩	1
schmerz	ʃmɛʁts	1
schmerzen	ʃmɛʁtsn	2
schmerzensgeld	ʃmɛʁt͡sn̩sɡɛlt	1
schmiergeld	ʃmiːɐ̯ɡɛlt	1
schminke	ʃmɪŋkə	1
schmuck	ʃmʊk	2
schmuck	ʃmʊkʰ	2
schnaps	ʃnaps	1
schnauze	ʃnaʊ̯tsə	1
schnee	ʃneː	5
schneiden	ʃnaɪ̯dn̩	4
schneiden	ʃnaɪ̯dən	4
schneider	ʃnaɪ̯dɐ	4
schneise	ʃnaɪ̯zə	1
schnell	ʃnɛl	45
schnelle	ʃnɛlə	10
schnellem	ʃnɛlm̩	1
schnellen	ʃnɛln̩	4
schneller	ʃnɛlɐ	15
schnellere	ʃnɛləʁə	2
schnelleres	ʃnɛləʁəs	1
schnelles	ʃnɛləs	3
schnellste	ʃnɛlstə	3
schnellsten	ʃnɛlstən	3
schnitt	ʃnɪt	5
schock	ʃɔk	3
schokolade	ʃokolaːdə	1
schon	ʃoːn	251
schon	ʃɔn	251
schon	ʃoːn	251
schön	ʃøːn	14
schöne	ʃøːnə	8
schöne	ʃøːnə	8
schönen	ʃøːnən	7
schöner	ʃøːnɐ	1
schönheit	ʃøːnhaɪ̯t	2
schönste	ʃøːnstə	2
schönsten	ʃøːnstən	6
schopf	ʃɔpf	2
schöpfen	ʃœpfən	2
schoss	ʃoːs	4
schräg	ʃʁɛːk	1
schräg	ʃʁeːk	1
schräg	ʃʁɛːç	1
schräg	ʃʁeːç	1
schrank	ʃʀaŋk	1
schranke	ʃʁaŋkə	1
schraube	ʃʁaʊ̯bə	2
schrauben	ʃraʊ̯bm̩	2
schrecken	ʃʁɛkən	1
schrecklich	ʃʀɛklɪç	1
schreiben	ʃʁaɪ̯bən	40
schreiben	ʃʀaɪ̯bm̩	40
schreiben	ʃʀaɪ̯bən	40
schreiber	ʃʀaɪ̯bɐ	1
schreibtisch	ʃʁaɪ̯ptɪʃ	3
schreien	ʃʁaɪ̯ən	2
schreiner	ʃʁaɪ̯nɐ	1
schreiten	ʃʀaɪ̯tn̩	1
schriftsteller	ʃʀɪftʃtɛlɐ	2
schrumpfen	ʃʁʊmpfən	1
schuhe	ʃuːə	3
schuld	ʃʊlt	9
schuldig	ʃʊldɪç	5
schule	ʃuːlə	12
schüler	ʃyːlɐ	10
schülerin	ʃyːləʁɪn	1
schülern	ʃyːlɐn	4
schulter	ʃʊltɐ	4
schulze	ʃʊltsə	1
schumacher	ʃuːmaxɐ	3
schuss	ʃʊs	6
schüsse	ʃʏsə	5
schusswaffe	ʃʊsvafə	1
schuster	ʃuːstɐ	3
schuster	ʃʊstɐ	3
schütteln	ʃʏtl̩n	1
schütteln	ʃʏtəln	1
schutz	ʃʊt͡s	11
schütz	ʃʏt͡s	1
schützen	ʃʏt͡sn̩	8
schützen	ʃʏt͡sən	8
schützen	ʃʏtsn̩	8
schützen	ʃʏtsən	8
schützengraben	ʃʏtsn̩ɡʀaːbm̩	1
schützengraben	ʃʏtsənɡʀaːbən	1
schwaben	ʃvaːbən	3
schwach	ʃvax	2
schwache	ʃvaχə	4
schwäche	ʃvɛçə	4
schwächen	ʃvɛçn̩	1
schwächen	ʃvɛçən	1
schwächen	ʃvɛçn̩	1
schwächen	ʃvɛçən	1
schwächung	ʃvɛçʊŋ	1
schwan	ʃvaːn	1
schwärmen	ʃvɛʁmən	1
schwarz	ʃvarts	3
schwarz	ʃvaʁt͡s	3
schweben	ʃveːbn̩	1
schweden	ʃveːdn̩	10
schwedin	ʃveːdɪn	1
schweigen	ʃvaɪ̯ɡən	1
schweigen	ʃvaɪɡən	1
schweiger	ʃvaɪ̯ɡɐ	3
schwein	ʃvaɪ̯n	1
schweinefleisch	ʃvaɪ̯nəflaɪ̯ʃ	1
schweiz	ʃvaɪ̯ts	38
schweizer	ʃvaɪ̯t͡sɐ	42
schweizweit	ʃvaɪ̯t͡svaɪ̯t	1
schwer	ʃveːɐ̯	30
schwere	ʃveːʀə	11
schweren	ʃveːʀən	12
schwerer	ʃveːʀɐ	3
schwerkraft	ʃveːɐ̯kʁaft	1
schwerpunkt	ʃveːɐ̯pʊŋkt	9
schwester	ʃvɛstɐ	4
schwierig	ʃviːrɪç	15
schwierig	ʃviːrik	15
schwimmen	ʃvɪmən	3
schwimmer	ʃvɪmɐ	1
schwindel	ʃvɪndl̩	1
schwindel	ʃvɪndəl	1
schwinden	ʃvɪndən	1
schwingen	ʃvɪŋən	2
schwitzen	ʃvɪtsən	1
schwung	ʃvʊŋ	7
schwungvoll	ʃvʊŋfɔl	1
sechs	zɛks	44
sechs	zɛks	44
sechsmal	zɛksmaːl	6
sechste	zɛkstə	3
sechzig	zɛçt͡sɪç	1
sediment	zedimɛnt	1
see	zeː	8
seele	zeːlə	2
segen	zeːɡən	4
sehen	zeːən	78
sehen	zeːn	78
sehen	zeːən	78
sehenswert	zeːənsveːɐ̯t	1
sei	zaɪ̯	218
seid	zaɪ̯t	4
seien	zaɪ̯ən	87
seife	zaɪ̯fə	1
seil	zaɪ̯l	1
sein	zaɪ̯n	286
sein	zaɪn	286
seine	zaɪ̯nə	190
seinem	zaɪ̯nəm	81
seinem	zaɪm	81
seinen	zaɪ̯nən	107
seinen	zaɪ̯n	107
seiner	zaɪ̯nɐ	96
seines	zaɪ̯nəs	24
seit	zaɪ̯t	200
seiten	zaɪ̯tən	26
seither	zaɪ̯theːɐ̯	5
sekt	zɛkt	2
sektor	zɛktoːɐ̯	2
sekunden	zekʊndn̩	16
selber	zɛlbɐ	18
selbst	zɛlpst	116
selbst	zɛlps	116
selbstmord	zɛlpstmɔʁt	2
selbstständig	zɛlpstʃtɛndɪç	1
selbsttätig	zɛlpsttɛːtɪç	1
selbstverständlich	zɛlpstfɛɐ̯ʃtɛntlɪç	5
selektiv	zelɛktiːf	2
selten	zɛltən	8
seltsam	zɛltzaːm	1
semiotisch	zemi̯oːtɪʃ	1
senat	zenaːt	6
senden	zɛndən	9
sender	zɛndɐ	6
sendung	zɛndʊŋ	8
senioren	zeni̯oːʁən	5
senioren	zɪnjoːʁən	5
senioren	zɛn-	5
senken	zɛŋkən	9
senkung	zɛŋkʊŋ	3
sensationell	zɛnzat͡si̯onɛl	1
sensibel	zɛnziːbl̩	1
seoul	seuːl	1
seoul	sɔʊ̯l	1
seoul	soːl	1
seoul	zeuːl	1
seoul	zɔʊ̯l	1
seoul	zoːl	1
separat	zeːpaʁaːt	1
separat	zɛpəʁaːt	1
september	zɛptɛmbɐ	31
serbien	zɛʁbi̯ən	3
serie	zeːʁiə	22
service	sœɐ̯vɪs	11
service	zœɐ̯vɪs	11
service	zɛʁviːs	11
service	zɛɐ̯viːs	11
service	zɛʁviːsə	11
service	zɛɐ̯viːsə	11
setzen	zɛtsən	16
sevilla	sevɪlja	1
sevilla	zevɪlja	1
sex	sɛks	6
sex	zɛks	6
sexuell	zɛksʊʔɛl	3
sexuell	sɛksʊʔɛl	3
sich	zɪç	1152
sicher	sɪçɐ	43
sicher	zɪçɐ	43
sicher	sɪçər	43
sicher	sixər	43
sicherheit	zɪçɐhaɪ̯t	27
sicherlich	zɪçɐlɪç	7
sichern	zɪçɐn	11
sicherstellen	zɪçɐʃtɛln̩	2
sicherstellen	zɪçɐʃtɛlən	2
sicherstellung	zɪçɐʃtɛlʊŋ	2
sicht	zɪçt	17
sichtbar	zɪçtbaːɐ̯	4
sichtfeld	zɪçtfɛlt	1
sichtweise	zɪçtvaɪ̯zə	1
sie	ziː	955
sie	zə	955
sie	ziː	955
sieben	ziːbm̩	28
sieben	ziːbən	28
sieben	ziːbən	28
siebenmal	ziːbn̩maːl	1
sieg	ziːk	26
siegen	ziːɡən	7
sieger	ziːɡɐ	6
siegfried	ziːkfʀiːt	2
siegt	ziːkt	2
siegt	ziːçt	2
siehst	ziːst	1
signal	zɪɡnaːl	5
signal	zɪknaːl	5
signifikant	zɪɡnifikant	2
silber	zɪlbɐ	6
simon	ziːmɔn	5
simpel	zɪmpl̩	1
simpel	zɪmpəl	1
sind	zɪnt	493
sind	zɪn	493
singen	zɪŋən	3
singen	zɪŋən	3
single	sɪŋəl	2
single	zɪŋəl	2
singt	zɪŋt	2
sinken	zɪŋkən	7
sinkt	zɪŋkt	6
sinn	zɪn	8
sinne	zɪnə	5
sinnvoll	zɪnfɔl	3
sitz	zɪt͡s	10
sitzen	zɪtsn̩	5
sitzen	zɪtsən	5
sizilien	zitsiːliən	1
skandal	skandaːl	7
skandinavien	skandinaːviən	1
skepsis	skɛpsɪs	3
ski	ʃiː	3
skurril	skʊʀiːl	1
slowakin	slovaːkɪn	1
slowene	sloveːnə	1
slowenien	sloveːni̯ən	1
smartphone	smaːɐ̯tfoːn	17
sms	ɛsʔɛmʔɛs	4
sms	ɛsɛmɛs	4
sms	-se-	4
sms	-zɛ-	4
sms	-ze-	4
so	zoː	422
sockel	zɔkəl	1
sofa	zoːfa	1
sofort	zofɔːɐ̯t	25
sohn	zoːn	14
solar	zolaːɐ̯	3
solch	zɔlç	6
solch	zɔʏ̯ç	6
solch	sɔlx	6
solch	solx	6
solche	zɔlçə	32
solche	zɔʎ̞çə	32
soldaten	zɔldaːtn	11
söldner	zœltnɐ	1
solid	zoliːt	1
solidarität	zolidaʀitɛːt	7
soll	zɔl	192
soll	zɔl	192
solle	zɔlə	7
sollen	zɔlən	100
sollt	zɔlt	1
sollte	zɔltə	91
sollten	zɔltn̩	45
sollten	zɔltən	45
solltet	zɔltət	1
somit	zoːmɪt	16
somit	zoːmɪt	16
sommer	zɔmɐ	33
sonde	zɔndə	1
sonder	zɔndɐ	2
song	sɔŋ	3
song	zɔŋ	3
sonne	zɔnə	2
sonne	zɔnə	2
sonnenfinsternis	zɔnənfɪnstɐnɪs	1
sonnenschein	zɔnənʃaɪ̯n	1
sonnensystem	zɔnənzʏsteːm	1
sonntag	zɔntaːk	50
sonntag	zɔntax	50
sonntag	zɔntaːx	50
sonst	zɔnst	27
sonst	zɔns	27
sony	zoːni	11
sony	soːni	11
sony	sɔʊ̯ni	11
sorge	zɔʁɡə	5
sorge	zɔʁɡə	5
sorgen	zɔrɡən	32
sorgen	zɔʁɡŋ̩	32
sorgen	zɔʁɡən	32
sortiment	zɔʁtimɛnt	2
sowieso	zoːʋizoː	2
sowieso	zoːʋizoː	2
sowieso	zoːvizo	2
sowieso	zovizoː	2
sowjetunion	zɔvjɛtʔuni̯oːn	6
sozial	zotsi̯aːl	1
sozialismus	zoːt͡si̯alɪsmʊs	1
sozialisten	zotsi̯alɪstn̩	2
sozialisten	zotsi̯alɪstən	2
sozialverträglich	zot͡sɪ̯aːlfɛɐ̯tʀɛːklɪç	1
soziologe	zotsɪ̯oloːɡə	1
sozusagen	zoːtsuzaːɡŋ̩	2
spagat	ʃpaɡaːt	2
spaghetti	ʃpaɡɛti	1
spaltet	ʃpaltət	1
spanien	ʃpaːni̯ən	13
spanier	ʃpaːni̯ɐ	6
spanne	ʃpanə	1
spannend	ʃpanənt	3
spannung	ʃpanʊŋ	8
spannungen	ʃpanʊŋən	3
sparen	ʃpaːɐ̯n	14
sparen	ʃpaːʀən	14
spargel	ʃpaʁɡl̩	1
sparkasse	ʃpaʀkasə	1
sparkasse	ʃpaɐ̯kasə	1
sparte	ʃpaʁtə	1
sparte	ʃpaːtə	1
spass	ʃpaːs	1
spass	ʃpas	1
spät	ʃpɛːt	4
spät	ʃpeːt	4
speck	ʃpɛk	1
speicher	ʃpaɪ̯çɐ	5
speicher	ʃpaɪ̯çɐ	5
speichern	ʃpaɪ̯çɐn	4
spektakulär	ʃpɛktakulɛːɐ̯	2
spektrum	ʃpɛktʁʊm	1
spekulieren	ʃpekuliːʀən	1
sperre	ʃpɛʁə	1
sperren	ʃpɛʁən	1
spesen	ʃpeːzən	1
spezial	ʃpet͡si̯aːl	2
speziell	ʃpetsi̯ɛl	7
spiegel	ʃpiːɡəl	17
spiel	ʃpiːl	50
spielen	ʃpiːlən	43
spieler	ʃpiːlɐ	33
spielzeug	ʃpiːlt͡sɔʏk	1
spital	ʃpitaːl	4
spitze	ʃpɪt͡sə	14
spitze	ʃpɪtsə	14
spitzen	ʃpɪtsn̩	2
spitzen	ʃpɪtsən	2
spitzen	ʃpɪtsn̩	2
spitzen	ʃpɪtsən	2
spitzenkandidat	ʃpɪt͡sn̩kandidaːt	1
spitzenkandidaten	ʃpɪtsn̩kandidaːtn̩	2
spitzenkandidatin	ʃpɪt͡sn̩kandidaːtɪn	1
spontan	ʃpɔntaːn	3
sport	ʃpɔʁt	16
sport	ʃpɔɐ̯t	16
sport	spɔʁt	16
sport	spɔɐ̯t	16
sportler	ʃpɔʁtlɐ	2
sportlerin	ʃpɔʁtlɐʁɪn	1
spott	ʃpɔt	1
sprache	ʃpʁaːxə	6
sprachen	ʃpʀaːχn̩	5
sprachkurs	ʃpʁaːχkʊʁs	1
sprachlos	ʃpʀaːχloːs	1
sprechen	ʃprɛçən	16
sprecher	ʃpʀɛçɐ	20
sprengen	ʃpʁɛŋən	1
sprengstoff	ʃpʀɛŋʃtɔf	1
spreu	ʃpʁɔɪ̯	1
sprich	ʃpʁɪç	1
spricht	ʃpʁɪçt	13
sprichwort	ʃpʁɪçvɔʁt	1
springen	ʃpʁɪŋən	4
spruch	ʃpʁʊχ	2
sprung	ʃpʀʊŋ	4
spülen	ʃpyːln̩	2
spülen	ʃpyːlən	2
spur	ʃpuːɐ̯	7
spürbar	ʃpyːɐ̯baːɐ̯	3
spüren	ʃpyːʁən	4
staat	ʃtaːt	31
staatsbürger	ʃtaːtsbʏʁɡɐ	2
stade	ʃtaːdə	1
stadium	ʃtaːdi̯ʊm	1
stadt	ʃtat	55
stadt	diː‿ʃtat	55
städte	ʃtɛtə	4
städte	ʃteːtə	4
städte	ʃtɛːtə	4
stadtteil	ʃtattaɪ̯l	5
staffel	ʃtafl̩	10
staffel	ʃtafəl	10
stahl	ʃtaːl	2
stall	ʃtal	3
stamm	ʃtam	1
stammen	ʃtamən	4
stand	ʃtant	38
stand	ʃtant	38
standard	standart	10
standard	ʃtandart	10
standardmässig	ʃtandaʁtmɛːsɪç	1
standhaft	ʃtanthaft	2
standrechtlich	ʃtantʀɛçtlɪç	1
stange	ʃtaŋə	2
stapel	ʃtaːpl̩	1
stapel	ʃtaːpəl	1
star	ʃtaːɐ̯	7
star	ʃtaː	7
star	ʃtaːɐ̯	7
star	ʃtaː	7
star	staːɐ̯	7
star	ʃtaːɐ̯	7
star	staː	7
star	ʃtaː	7
stark	ʃtark	34
stärke	ʃtɛrkə	8
start	ʃtaʁt	24
start	ʃtaːt	24
startbahn	ʃtaʁtbaːn	3
starten	ʃtaʁtən	8
starten	ʃtaːtən	8
station	ʃtat͡si̯oːn	3
statistiker	ʃtatɪstikɐ	1
statt	ʃtat	37
statt	ʃtat	37
statue	ʃtaːtuɐ̯	1
statue	ʃtaːtu̯ə	1
statue	staːtu̯ə	1
status	ʃtaːtʊs	3
status	staːtʊs	3
status	staːtuːs	3
staub	ʃtaʊ̯p	1
staunen	ʃtaʊ̯nən	1
staunen	ʃtaunən	1
steckdose	ʃtɛkdoːzə	3
stecken	ʃtɛkən	9
stehen	ʃteːən	61
stehen	ʃteːn	61
steige	ʃtaɪ̯ɡə	1
steigen	ʃtaɪ̯ɡən	10
steigt	ʃtaɪ̯kt	13
steigt	ʃtaɪ̯çt	13
stein	ʃtaɪn	4
steinigung	ʃtaɪ̯niɡʊŋ	1
stelle	ʃtɛlə	13
stellung	ʃtɛlʊŋ	5
stemmen	ʃtɛmən	2
stempel	ʃtɛmpəl	1
sterben	ʃtɛʁbən	5
stern	ʃtɛʁn	3
sterne	ʃtɛʁnə	3
stets	ʃteːts	15
steuern	ʃtɔɪ̯ɐn	9
steuerung	ʃtɔɪ̯əʀʊŋ	2
stich	ʃtɪç	1
stichprobe	ʃtɪçproːbə	1
stiefvater	ʃtiːffaːtɐ	1
stiefvater	ʃtiːffaːtər	1
stieg	ʃtiːk	12
stift	ʃtɪft	1
stiftung	ʃtɪftʊŋ	5
stil	stiːl	6
stil	ʃtiːl	6
still	ʃtɪl	2
stille	ʃtɪlə	3
stillen	ʃtɪlən	1
stimme	ʃtɪmə	4
stimmen	ʃtɪmən	21
stimulation	ʃtimulat͡si̯oːn	1
stinken	ʃtɪŋkən	1
stock	ʃtɔk	2
stoff	ʃtɔf	3
stollen	ʃtɔlən	1
stolz	ʃtɔlt͡s	9
stolz	ʃtɔlt͡s	9
stopp	ʃtɔp	3
stoppen	ʃtɔpən	3
stöpsel	ʃtœpsəl	1
stören	ʃtøːɐ̯n	2
stören	ʃtøːrən	2
story	stɔʁi	3
story	stɔɹi	3
strafe	ʃtʁaːfə	11
strafe	ʃtʀaːfə	11
strafen	ʃtʀaːfɱ̩	5
strafen	ʃtʀaːfən	5
strahlen	ʃtʁaːlən	1
strand	ʃtrant	2
strasse	ʃtraːsə	1
strassen	ʃtʀaːsn̩	4
strassen	ʃtʀaːsən	4
strassenbahn	ʃtraːsənbaːn	1
strategie	ʃtʀateɡiː	7
strauch	ʃtʀaʊ̯χ	1
streich	ʃtʀaɪ̯ç	1
streichen	ʃtʀaɪ̯çn̩	2
streichen	ʃtʀaɪ̯çən	2
streifen	ʃtʀaɪ̯fn̩	1
streifen	ʃtʁaɪ̯fən	1
streifenwagen	ʃtʀaɪ̯fn̩vaːɡn̩	1
streik	ʃtʀaɪ̯k	8
streiken	ʃtʁaɪ̯kən	4
streit	ʃtʁaɪ̯t	10
streiten	ʃtʁaɪ̯tən	2
streng	ʃtʀɛŋ	4
stresstest	ʃtʁɛstɛst	2
streubesitz	ʃtʀɔɪ̯bəzɪt͡s	1
strg	ʃtɔɪ̯ərʊŋk	1
strg	ɛsteːɛrɡeː	1
strg	strɔŋ	1
strg	strɪŋ	1
strich	ʃtʁɪç	5
strick	ʃtʁɪk	1
strick	ʃtʀɪk	1
strom	ʃtʁoːm	10
strömen	ʃtʁøːmən	2
struktur	ʃtʀʊktuːɐ̯	1
strukturieren	ʃtʁʊktuʁiːʁən	1
strukturiert	ʃtʁʊktuʁiːʁt	1
stück	ʃtʏk	13
stücke	ʃtʏkə	4
student	ʃtudɛnt	3
studenten	ʃtudɛntən	5
studenten	ʃtudɛntn̩	5
studie	ʃtuːdi̯ə	23
studieren	ʃtudiːrən	5
studium	ʃtuːdi̯ʊm	7
stufe	ʃtuːfə	1
stuhl	ʃtuːl	2
stühle	ʃtyːlə	1
stumpf	ʃtʊmpf	2
stumpf	ʃtʊmpf	2
stunde	ʃtʊndə	17
stunden	ʃtʊndən	41
sturheit	ʃtuːɐ̯haɪ̯t	1
sturm	ʃtʊʁm	8
sturm	ʃtʊʁm	8
stürme	ʃtʏʁmə	2
stürmer	ʃtʏrmər	8
sturz	ʃtʊʁts	6
stützen	ʃtʏtsən	3
stützen	ʃtʏtsn̩	3
stützen	ʃtʏtsən	3
suchen	zuːxən	17
sucht	zʊxt	11
suchten	sʊxtən	2
suchten	zʊxtən	2
suchten	suːxtən	2
suchten	zuːxtən	2
süd	zyːt	1
südafrika	zyːtʔaːfʁika	2
sudan	zudaːn	1
süden	zyːdən	5
südkorea	zyːtkoʁeːa	5
südkoreaner	zyːtkoʁeaːnɐ	3
südlich	zyːtlɪç	2
suizid	zuːitsiːt	2
suizid	zuːitsɪt	2
sultan	zʊltaːn	1
sündhaft	zʏnthaft	1
super	zuːpɐ	8
super	zuːpɐ	8
supermarkt	zuːpɐmaʁkt	1
suppe	zʊpə	1
susanne	zuzanə	2
susanne	susanə	2
sven	svɛn	4
sven	tsvɛn	4
symbol	zʏmboːl	1
symbolisch	zʏmboːlɪʃ	2
synagoge	zynaɡoːɡə	2
synonym	zynonyːm	1
syrer	zyːʁɐ	5
syrien	zyːʁiən	25
syrier	zyːʀi̯ɐ	1
system	zɪsteːm	21
system	zʏsteːm	21
systematisch	zʏstemaːtɪʃ	3
szene	st͡seːnə	11
szene	seːnə	11
szene	t͡seːnə	11
t	teː	1
tabak	taːbak	1
tabak	tabak	1
tabak	tabak	1
tabelle	tabɛlə	3
tablet	tɛblət	5
tabu	tabuː	1
tabu	tabuː	1
tag	taːk	58
tag	tɑːk	58
tag	tax	58
tag	tɑːx	58
tag	tɑːɡ̊	58
tage	taːɡə	22
tage	taːɡə	22
tagen	taːɡən	41
tagen	taːɡən	41
tages	taːɡəs	14
tageslicht	taːɡəslɪçt	1
tageszeitung	taːɡəst͡saɪ̯tʊŋ	2
täglich	tɛːklɪç	15
tags	taːks	1
tal	taːl	2
talent	talɛnt	1
taliban	taːlɪbaːn	5
talk	talk	2
talk	tɔːk	2
talk	toːk	2
talkshow	tɔːkʃoː	2
talkshow	toːk-	2
talkshow	-ʃɔʊ̯	2
tanja	tanja	1
tante	tantə	2
tanz	tants	1
tanzen	tantsən	2
tänzer	tɛnt͡sɐ	2
tanzt	tant͡st	2
tappen	tapən	1
tarif	taʀiːf	4
taschentuch	taʃəntuːx	1
tasse	tasə	1
tastatur	tastatuːɐ̯	3
tasten	tastən	2
tat	taːt	14
taten	taːtn̩	6
taten	taːtən	6
taten	taːtn̩	6
taten	taːtən	6
täten	tɛːtən	1
täter	tɛːtɐ	20
täter	teːtɐ	20
täter	tɛːtər	20
tätigkeit	tɛːtɪçkaɪ̯t	3
tätigkeiten	tɛːtɪçkaɪ̯tən	1
tatsache	taːtzaxə	7
tatsächlich	taːtzɛçlɪç	33
tauber	taʊ̯bər	1
taucher	taʊ̯χɐ	3
taucht	taʊ̯xt	1
taugt	taʊ̯kt	1
taugt	taʊ̯xt	1
tausch	taʊ̯ʃ	1
täuschung	tɔɪ̯ʃʊŋ	1
tausend	taʊ̯zn̩t	5
tausend	taʊ̯zənt	5
taxi	taksi	3
taxifahrer	taksifaːʁəʁ	2
team	tiːm	45
teamgeist	tiːmɡaɪ̯st	1
technik	tɛçnɪk	5
techniker	tɛçnikɐ	2
technologie	tɛçnoloɡiː	7
teddybär	tɛdibɛːɐ̯	1
tee	teː	4
tee	tiː	4
teenager	tiːnɛɪ̯dʒɐ	4
teenager	tiːnedʒɐ	4
teenager	teːnaːɡɐ	4
teheran	teːheʁaːn	3
teheran	teːəʁaːn	3
teich	taɪ̯ç	1
teiche	taɪ̯çə	1
teil	taɪ̯l	53
teile	taɪ̯lə	10
teilen	taɪ̯lən	24
teilhabe	taɪ̯lhaːbə	3
teilnehmer	taɪ̯lneːmɐ	15
teilung	taɪ̯lʊŋ	2
teilweise	taɪ̯lvaɪ̯zə	13
teint	tɛ̃ː	1
telefon	teːləfoːn	2
telefon	tɛləfoːn	2
telefon	teːləfoːn	2
telefon	tɛləfoːn	2
telefonieren	telefoniːʁən	2
teleskop	teːləskoːp	1
teleskop	tɛlə-	1
tempel	tɛmpl̩	1
tempel	tɛmpəl	1
temperatur	tɛmpəʁatuːɐ̯	3
temperatur	tɛmpʁatuːɐ̯	3
temperaturen	tɛmpəʀatuːʀən	2
tempo	tɛmpo	6
temporär	tɛmpoʁɛːɐ̯	1
tendenz	tɛndɛns	4
tennis	tɛnɪs	5
termin	tɛʁmiːn	2
termingerecht	tɛʁmiːnɡəʀɛçt	1
terror	tɛʀoːɐ̯	3
terrorist	tɛrorɪst	1
terroristischer	tɛʁoʁɪstɪʃɐ	1
test	tɛst	10
testen	tɛstən	8
tests	tɛsts	11
teuer	tɔʏ̯ɐ	8
teufel	tɔʏ̯fəl	2
teufelskreis	tɔɪ̯fl̩skʁaɪ̯s	1
texas	tɛksas	1
text	tɛkst	7
theater	teaːtɐ	5
thema	teːma	45
thema	teːmɐ	45
themen	teːmən	19
theorie	teoʁiː	2
theorien	teoʀiːən	1
thriller	θʁɪlɐ	1
thriller	sʁɪlɐ	1
thriller	sɹɪlɐ	1
thriller	θɹɪlɐ	1
thriller	tʁɪlɐ	1
thüringen	tyːʀɪŋən	5
thüringer	tyːʁɪŋəʁ	1
tief	tiːf	7
tier	tiːɐ̯	4
tiergarten	tiːɐ̯ɡaʁtn̩	1
tierschützer	tiːɐ̯ʃʏtsɐ	1
tiger	tiːɡɐ	1
tinte	tɪntə	1
tippen	tɪpən	1
tirol	tiʀoːl	4
tisch	tɪʃ	6
tische	tɪʃə	2
titel	tiːtl	23
titel	tɪtl	23
titeln	tiːtəln	1
toast	toːst	1
tochter	tɔxtɐ	20
tod	toːt	11
tod	toːd̥	11
todesstrafe	toːdəsʃtʁaːfə	4
tödlich	tøːtlɪç	2
toilette	to̯alɛtə	1
toilette	tolɛtə	1
tokio	toːki̯o	6
toll	tɔl	2
tolle	tɔlə	1
tommy	tɔmi	1
tonne	tɔnə	5
tonnen	tɔnən	7
tool	tuːl	4
topf	tɔpf	1
tor	toːɐ̯	23
tore	toːʀə	9
toren	toːʀən	3
torlos	toːɐ̯loːs	1
torpedieren	tɔʁpediːʁən	1
torschütze	toːɐ̯ʃʏtsə	2
torschützen	toːɐ̯ʃʏtsn̩	1
torschützen	toːɐ̯ʃʏtsən	1
tot	toːt	7
töten	tøːtən	1
tottenham	tɔtənhɛm	1
tottenham	tɔtənəm	1
tough	taf	1
tour	tuːɐ̯	4
toyota	tojoːta	5
trabi	tʀabi	1
tradition	tʁadit͡si̯oːn	5
traf	tʀaːf	10
tragbar	tʀaːkbaːɐ̯	1
tragen	tʁaːɡən	20
tragen	tʁaːɡŋ̩	20
träger	tʀɛːɡɐ	1
tragfähig	tʀaːkfɛːɪç	1
tragische	tʁaːɡɪʃə	1
tragisches	tʁaːɡɪʃəs	1
tragödie	tʁaɡøːdi̯ə	3
trägt	tʁɛːkt	12
trägt	tʁeːçt	12
trägt	tʁɛːçt	12
trainer	tʁɛːnɐ	38
trainer	tʁeːnɐ	38
trainer	tʁɛɪ̯nɐ	38
trainieren	tʁɛniːʁən	2
training	trɛːnɪŋ	19
training	treːnɪŋ	19
tram	tram	1
transformation	tʁansfɔʁmat͡si̯oːn	1
transparent	tʁanspaʁɛnt	3
trat	tʀaːt	6
trauben	tʀaʊ̯bən	1
trauen	tʀaʊ̯ən	4
trauer	tʀaʊ̯ɐ	7
traum	tʀaʊ̯m	6
träume	tʀɔɪ̯mə	3
träumen	tʀɔɪ̯mən	4
traurig	tʁaʊ̯ʁɪç	1
treffen	tʁɛfɱ̩	33
treffen	tʁɛfən	33
treffer	tʀɛˑfɐ	12
treiben	tʀaɪ̯bm̩	5
treiben	tʀaɪ̯bən	5
treiber	tʀaɪ̯bɐ	2
trennen	tʀɛnən	4
tresor	tʀezoːɐ̯	1
treu	tʁɔʏ̯	1
treue	tʀɔɪ̯ə	2
trick	tʀɪk	3
trieb	tʁiːp	1
triest	tʀiɛst	1
trikot	tʁikoː	2
trikot	tʁɪko	2
trilemma	tʀilɛma	1
trinke	tʁɪŋkə	1
trinken	tʁɪŋkən	5
trinken	trɪŋkən	5
trinken	tʁɪŋkən	5
trinkwasser	tʀɪŋkvasɐ	2
trip	trɪp	1
tritt	tʁɪt	15
trivial	tʁiviaːl	1
trocken	tʁɔkən	1
troll	tʀɔl	1
tropfen	tʁɔpfən	2
tropfen	tʀɔpfɱ̩	2
tropfen	tʀɔpfən	2
trott	tʀɔt	1
trotz	trɔts	38
trotz	tʁɔt͡s	38
trüben	tʀyːbn̩	3
trumpf	tʁʊmpf	1
truppen	tʀʊpm̩	5
truppen	tʀʊpən	5
tschechien	t͡ʃɛçi̯ən	6
tschuri	tʃʊʁiː	2
tschüss	t͡ʃʏs	2
tschüss	tʃʏs	2
tschüss	tʃyːs	2
tu	tuː	2
tuch	tuːx	1
tückisch	tʏkɪʃ	1
tue	tuːə	5
tun	tuːn	38
tun	tuːn	38
tunesien	tuneːzi̯ən	1
tunesier	tuneːzi̯ɐ	1
tunnel	tʊnəl	1
tunnel	tunɛl	1
tür	tyːr	7
tür	tyːɐ̯	7
türen	tyːʁən	5
turin	turiːn	3
turiner	tuʀiːnɐ	1
turm	tʊʁm	3
türsteher	tyːɐ̯ʃteːɐ	1
tut	tuːt	15
tüv	tʏf	1
tweet	tviːt	7
twitter	tvɪtər	23
twittern	tvɪtərn	2
type	tyːpə	1
u	ʔuː	2
übel	ʔyːbl̩	2
übel	ʔyːbl̩	2
übel	ʔyːbəl	2
über	yːbɐ	408
über	ʏbɐ	408
überall	yːbɐʔal	10
überall	yːbəʁal	10
überall	ʏbɐʔal	10
überbleibsel	yːbɐblaɪ̯bzəl	1
überblick	yːbɐblɪk	15
überdurchschnittlich	yːbɐdʊʁçʃnɪtlɪç	2
überfallen	ʔyːbɐfalən	2
überflüssig	yːbɐflʏsɪç	4
überführen	ʔyːbɐfyːɐ̯n	2
überführen	ʔyːbɐfyːɐ̯n	2
überführen	ʔyːbɐfyːʁən	2
überführen	ʔyːbɐfyːɐ̯n	2
überführen	ʔyːbɐfyːʁən	2
übergang	yːbɐɡaŋ	2
übergangsregierung	yːbɐɡaŋsʁeɡiːʁʊŋ	2
übergeben	yːbɐɡeːbən	1
überhaupt	yːbɐhaʊ̯pt	33
überholen	yːbɐhoːlən	4
überlassen	yːbɐlasn̩	3
überlassen	ʔyːbɐlasn̩	3
überleben	ʔyːbɐleːbm̩	6
überleben	ʔyːbɐleːbən	6
überleben	ʔyːbɐleːbm̩	6
überleben	ʔyːbɐleːbən	6
überlegen	ʔyːbɐleːɡŋ̩	4
überlegen	ʔyːbɐleːɡən	4
überlegung	ybɐleːɡʊŋ	1
übernachtung	ʔyːbɐnaxtʊŋ	1
übernahme	yːbɐnaːmə	7
übernehmen	ʔyːbɐneːmən	7
überprüfen	ʔyːbɐpʀyːfɱ̩	2
überprüfen	ʔyːbɐpʀyːfən	2
überqueren	ʔyːbɐkveːʀən	2
überqueren	ʔyːbɐkveːɐ̯n	2
überraschen	yːbɐʀaʃn̩	2
überraschen	yːbɐʀaʃən	2
überraschend	yːbɐʀaʃənt	13
überrascht	yːbɐʀaʃt	6
überraschung	yːbɐʀaʃʊŋ	1
überraschungen	yːbɐʀaʃʊŋən	3
überschreiten	yːbəʁʃʁaɪ̯tən	1
übersehen	ybəʁzeːən	3
übersetzer	yːbɐzɛtsɐ	1
übersetzern	yːbɐzɛtsɐn	1
übersicht	yːbɐzɪçt	9
überteuert	yːbɐtɔɪ̯ɐt	1
übertragen	ybəʁtʁaːɡən	5
übertragung	yːbɐtʁaːɡʊŋ	4
übertreffen	yːbəʁtʁɛfən	3
übertreiben	yːbəʁtʁaɪ̯bən	1
überwachen	yːbəʁvaχən	2
überwachung	yːbəʁvaχʊŋ	2
überweisen	yːbəʁvaɪ̯zən	1
überwinden	ʔyːbɐvɪndn̩	2
überwinden	ʔyːbɐvɪndən	2
überzeugen	yːbəʁtsɔʏ̯ɡən	6
überzeugung	yːbəʁtsɔʏ̯ɡʊŋ	3
übrig	yːbʁɪç	4
übrig	yːbrik	4
übrig	ʏbʁɪç	4
übrigens	yːbʁɪɡəns	10
übrigens	yːbəʁɪŋs	10
übrigens	ʏbəʁɪŋs	10
übungen	ʔyːbʊŋən	1
uhr	uːr	135
uhren	ʔuːɐ̯n	1
uhren	ʔuːʀən	1
ukraine	ukʁaiːnə	21
ukraine	ukʁaɪ̯nə	21
ukrainisch	ukʀaɪ̯nɪʃ	1
ukrainisch	ukʀaˑiːnɪʃ	1
ukrainisch	ukʀaɪ̯nɪʃ	1
ukrainisch	ukʀaˑiːnɪʃ	1
um	ʊm	543
umbauen	ʊmbaʊ̯ən	2
umbringen	ʔʊmbʀɪŋən	1
umfeld	ʔʊmfɛlt	8
umfrage	ʊmfʀaːɡə	8
umgang	ʊmɡaŋ	14
umgebung	ʊmɡeːbʊŋ	5
umgehen	ʊmɡeːən	2
umgehen	ʊmɡeːən	2
umgehend	ʊmɡeːənt	3
umgehend	ʊmɡeːənt	3
umher	ʊmheːɐ̯	1
umsetzung	ʊmzɛtsʊŋ	6
umsonst	ʊmzɔnst	1
umsteigen	ʔʊmʃtaɪ̯ɡŋ̩	1
umsteigen	ʔʊmʃtaɪ̯ɡən	1
umstrukturieren	ʊmʃtʁʊktuʁiːʁən	1
umwelt	ʊmvɛlt	5
umziehen	ʔʊmtsiːən	1
umzug	ʔʊmt͡suːk	4
unabhängigkeit	ʊnʔaphɛŋɪçkaɪ̯t	2
unangenehm	ʊnanɡəneːm	1
unauffindbar	ʊnʔaʊ̯ffɪntbaːɐ̯	1
unauflöslich	ʊnʔaʊ̯fløːslɪç	1
unbegründet	ʊnbəɡʀʏndət	1
unbeirrbar	ʊnbəʔɪʁbaːɐ̯	1
unbeirrt	ʊnbəʔɪʁt	2
unbenommen	ʊnbənɔmən	1
unbenommen	ʊnbənɔmən	1
unbewaffnet	ʊnbəvafnət	1
unbewusst	ʊnbəvʊst	1
und	ʊnt	3353
und	ʊn	3353
undercut	andɐkat	1
unentbehrlich	ʔʊnʔɛntbeːɐ̯lɪç	1
unerschwinglich	ʊnʔɛɐ̯ʃvɪŋlɪç	1
unerträglich	ʊnɛɐ̯tʀɛːklɪç	1
unfähig	ʊnfeːɪç	1
unfähig	ʊnfɛːɪç	1
unfair	ʊnfɛːɐ̯	1
unfall	ʊnfal	16
unfälle	ʔʊnfɛlə	5
ungarn	ʊnɡarn	10
ungarn	ʊnɡaːn	10
ungebremst	ʊnɡəbʀɛmst	1
ungefragt	ʊnɡəfʁaːkt	1
ungefragt	ʊnɡəfʁaːxt	1
ungefragt	ʊŋɡə-	1
ungeordnet	ʊnɡəʔɔʁdnət	2
ungesund	ʊnɡəzʊnt	1
ungewöhnlich	ʊnɡəvøːnlɪç	2
unglaublich	ʊnɡlau̯plɪç	2
ungleich	ʊnɡlaɪ̯ç	1
unglück	ʊnɡlʏk	5
unhöflich	ʔʊnhøːflɪç	2
uni	ʊni	4
union	uni̯oːn	25
universal	univɛʁzaːl	1
universität	univɛʁzitɛːt	11
universitäten	ʔunivɛʁzitɛːtn̩	1
universitäten	ʔunivɛʁzitɛːtən	1
unkompliziert	ʊnkɔmplit͡siːɐ̯t	1
unmittelbar	ʊnmɪtəlbaːɐ̯	6
unmittelbar	ʊnmɪtəlbaːɐ̯	6
unmöglich	ʔʊnmøːklɪç	4
unmut	ʊnmuːt	4
unnahbar	ʊnnaːbaːɐ̯	1
unnötig	ʊnøːtɪç	3
unordnung	ʔʊnʔoʁdnʊŋ	1
unrecht	ʊnʀɛçt	1
unrecht	ʔʊnʀɛçt	1
unsanft	ʊnzanft	1
unscharf	ʊnʃaʁf	1
unschuld	ʊnʃʊlt	2
unschuldig	ʊnʃʊldɪç	1
unser	ʔʊnzɐ	25
unsicher	ʊnzɪçɐ	3
unten	ʊntn̩	17
unter	ʊntɐ	218
unterart	ʊntɐʔaːɐ̯t	1
unterdrückung	ʊntɐdʀʏkʊŋ	1
unterdurchschnittlich	ʊntɐdʊʁçʃnɪtlɪç	2
untereinander	ʊntəʁaɪ̯nandəʁ	1
untergang	ʔʊntɐɡaŋ	1
unterhalten	ʊntəʁhaltən	3
unterhaus	ʊntɐhaʊ̯s	1
unterholz	ʊntəʁhɔlts	1
unterhose	ʊntɐhoːzə	1
unterhosen	ʊntɐhoːzn	1
unterkunft	ʊntɐkʊnft	5
unterlassen	ʊntəʁlasən	2
untermauern	ʊntɐmaʊ̯ɐn	1
unternehmen	ʊntɐneːmən	98
unternehmen	ʊntɐneːmən	98
unternehmer	ʊntɐneːmɐ	5
unterschenkel	ʔʊntɐʃɛŋkl̩	1
unterschied	ʔʊntʰɐʃiːt	14
unterschiedlich	ʊntɐʃiːtlɪç	4
unterschreiben	ʊntɐʃʁaɪ̯bən	1
unterschreiben	ʊntɐʃʁaɪ̯bən	1
unterschreiten	ʊntɐʃʁaɪ̯tən	1
unterstützen	ʊntɐʃtʏt͡sən	15
untersuchen	ʔʊntɐzuːxən	2
untersuchung	ʊntɐzuːxʊŋ	5
untersuchungsausschuss	ʊntɐzuːχʊŋsʔaʊ̯sʃʊs	2
unterwegs	ʊntɐveːks	18
unverbraucht	ʊnfɛɐ̯bʀaʊ̯χt	1
unvergessen	ʊnfɛɐ̯ɡɛsn̩	1
unvermindert	ʊnfɛɐ̯mɪndɐt	1
unvermittelt	ʊnfɛɐ̯mɪtl̩t	1
unwahrscheinlich	ʊnvaːɐ̯ʃaɪ̯nlɪç	4
unwahrscheinlich	ʊnvaːɐ̯ʃaɪ̯nlɪç	4
unweigerlich	ʊnvaɪ̯ɡɐlɪç	2
unzüchtig	ʊnt͡sʏçtɪç	1
unzufriedenheit	ʔʊnt͡sufʁiːdənhaɪ̯t	3
üppig	ʏpɪç	1
urban	ʊʁbaːn	1
urlauber	uːɐ̯laʊ̯bɐ	2
urne	ʔʊʁnə	1
ursache	uːɐ̯zaxə	8
ursachen	uːɐ̯zaxən	3
ursprung	uːɐ̯ʃpʁʊŋ	1
ursprünglich	ʔuːɐ̯ʃpʁʏŋlɪç	9
urteil	ʊʁtaɪ̯l	14
urteilen	ʊʁtaɪ̯lən	4
uwe	uːvə	2
v	faʊ̯	4
vater	faːtər	24
vater	faːtɐ	24
väter	fɛːtɐ	1
väterlich	fɛːtɐlɪç	1
vaters	faːtɐs	5
vaterschaft	faːtɐʃaft	1
velo	veːlo	1
verabscheuen	fɛɐ̯ʔapʃɔɪ̯ən	1
verachten	fɛɐ̯aχtən	1
verachtung	fɛɐ̯ʔaχtʊŋ	1
verändern	fɛɐ̯ʔɛndɐn	2
veranstalter	fɛɐ̯ʔanʃtaltɐ	6
verantworten	fɛʁʔantvɔʁtən	2
verärgern	fɛʁʔɛʁɡɐn	2
verärgert	fɛɐ̯ʔɛʁɡɐt	4
verärgert	fɐ-	4
verband	fɛɐ̯bant	11
verband	fɛɐ̯bant	11
verbannen	fɛʁbanən	1
verbannt	fɛɐ̯bant	1
verbergen	fɛɐ̯bɛʁɡŋ̩	1
verbessern	fɛɐ̯bɛsɐn	11
verbesserung	fɛɐ̯bɛsəʀʊŋ	3
verbindung	fɛɐ̯bɪndʊŋ	9
verbindungen	fɛɐ̯bɪndʊŋən	4
verbitterung	fɛɐ̯bɪtəʁʊŋ	1
verbleib	fɛʁblaɪ̯p	2
verbohrtheit	fɛɐ̯boːɐ̯thaɪ̯t	1
verborgen	fɛɐ̯bɔʁɡn̩	1
verboten	fɛɐ̯boːtn̩	8
verboten	fɛɐ̯boːtən	8
verbrauch	fɛɐ̯bʀaʊ̯x	1
verbrauchen	fɛɐ̯bʀaʊ̯χən	1
verbrauchen	fɛɐ̯bʀaʊ̯χən	1
verbraucher	fɛʁbʁaʊ̯χəʁ	8
verbrecher	fɛɐ̯bʀɛçɐ	1
verbreiten	fɛɐ̯bʀaɪ̯tn̩	2
verbreitung	fɛɐ̯bʀaɪ̯tʊŋ	3
verbrennen	fɛɐ̯bʀɛnən	1
verbundenheit	fɛɐ̯bʊndn̩haɪ̯t	2
verdacht	fɛɐ̯daχt	10
verdammt	fɛɐ̯damt	2
verdampfung	fɛʁdampfʊŋ	1
verdanken	fɛʁdaŋkən	1
verdauen	fɛʁdaʊ̯ən	1
verdienen	fɛɐ̯diːnən	6
verdreht	fɛɐ̯dʀeːt	1
verehren	fɛɐ̯eːʀən	1
verehrt	fɛɐ̯ʔeːɐ̯t	1
verein	fɛɐ̯ʔaɪ̯n	21
vereinbaren	fɛʁaɪ̯nbaːʁən	2
vereinigung	fɛɐ̯ʔaɪ̯nɪɡʊŋ	2
vererbt	fɛɐ̯ʔɛʁpt	1
verfassung	fɛɐ̯fasʊŋ	4
verfeindet	fɛɐ̯faɪ̯ndət	1
verfolgen	fɛɐ̯fɔlɡŋ̩	9
verfolgen	fɛɐ̯fɔlɡən	9
verfügbar	fɛɐ̯fyːkbaːɐ̯	14
verfügen	fɛʁfyːɡən	1
verfügung	fɛɐ̯fyːɡʊŋ	24
vergangenheit	fɛɐ̯ɡaŋənhaɪ̯t	13
vergeben	fɛʁɡeːbən	8
vergeben	fɐ-	8
vergeblich	fɛʁɡeːplɪç	3
vergehen	fɛʁɡeːən	3
vergeltung	fərɡɛltʊŋ	1
vergeltung	fɛr-	1
vergessen	fɛɐ̯ɡɛsən	9
vergewaltigen	fɛʁɡəvaltiɡən	1
vergewaltigung	fɛʁɡəvaltiɡʊŋ	1
vergleich	fɛɐ̯ɡlaɪ̯ç	30
vergleichbar	fɛɐ̯ɡlaɪ̯çbaːɐ̯	1
vergleiche	fɛʁɡlaɪ̯çə	2
vergleiche	fɛʁɡlaɪ̯çə	2
vergleichen	fɛʁɡlaɪ̯çən	5
vergnügen	fɛɐ̯ɡnyːɡŋ̩	2
vergnügen	fɛɐ̯ɡnyːɡən	2
vergolden	fɛɐ̯ɡɔldn̩	1
vergraben	fɛɐ̯ɡʀaːbm̩	1
vergraben	fɛɐ̯ɡʀaːbən	1
vergütung	fɛɐ̯ɡyːtʊŋ	1
verhalten	fɛɐ̯haltn̩	15
verhalten	fɛɐ̯haltən	15
verhalten	fɛɐ̯haltn̩	15
verhalten	fɛɐ̯haltən	15
verhältnis	fɛɐ̯hɛltnɪs	9
verhandeln	fɛɐ̯handl̩n	6
verhandeln	fɛɐ̯handəln	6
verhängnis	fɛɐ̯hɛŋnɪs	3
verhindern	fɛɐ̯hɪndɐn	12
verhütung	fɛɐ̯hyːtʊŋ	2
verhütung	fɐ-	2
verkauf	fɛɐ̯kaʊ̯f	14
verkaufen	fɛɐ̯kaʊ̯fən	9
verkäufer	fɛɐ̯kɔɪ̯fɐ	2
verkehr	fɛrkeːr	10
verkennen	fɛɐ̯kɛnn̩	1
verkennen	fɛɐ̯kɛnən	1
verklagen	fɛʁklaːɡən	1
verkleinern	fɛɐ̯klaɪ̯nɐn	1
verknüpfung	fɛʁknʏpfʊŋ	1
verkommen	fɛɐ̯kɔmən	1
verkraftbar	fɛɐ̯kʀaftbaːɐ̯	1
verkürzen	fɛɐ̯kʏʁt͡sən	3
verlag	fɛɐ̯laːk	2
verlag	fɐlaːk	2
verlag	fɐlax	2
verlag	fɐlaːx	2
verlangen	fɛɐlaŋən	5
verlangen	fɛʁlaŋən	5
verlängern	fɛɐ̯lɛŋɐn	2
verlassen	fɛɐ̯lasən	17
verlauf	fɛɐ̯laʊ̯f	3
verlaufen	fɛɐ̯lau̯fən	4
verlegen	fɛɐleːɡən	1
verlegen	fɛɐleːɡn̩	1
verleihen	fɛɐ̯laɪ̯ən	3
verletzen	fɛɐ̯lɛt͡sn̩	2
verletzt	fɐlɛt͡st	32
verletzung	fɛɐ̯lɛt͡sʊŋ	3
verletzungsbedingt	fɛɐ̯lɛt͡sʊŋsbədɪŋt	1
verlierer	fɛɐ̯liːʀɐ	1
vermeidbar	fɛɐ̯maɪ̯tbaːɐ̯	1
vermeiden	fɛɐ̯maɪ̯dən	2
vermeintlich	fɛɐ̯maɪ̯ntlɪç	3
vermieter	fɛɐ̯miːtɐ	4
vermittelbar	fɛɐ̯mɪtl̩baːɐ̯	1
vermittlung	fɛʁmɪtlʊŋ	1
vermögen	fɛʁmøːɡən	3
vermuten	fɛɐ̯muːtən	2
vernehmen	fɛʁneːmən	3
vernunft	fɛɐ̯nʊnft	1
vernünftig	fɛɐ̯nʏnftɪç	1
veröffentlichen	fɛɐ̯œfn̩tlɪçn	3
veröffentlichen	fɛɐ̯œfən̩tlɪçən	3
verona	veʁoːna	1
verpacken	fɛʁpakən	1
verrat	fɛɐ̯ʀaːt	1
verrichten	fɛʁɪçtən	1
verrückt	fɛɐʁʏkt	3
vers	fɛʁs	1
verschärfung	fɛʁʃɛʁfʊŋ	2
verschenken	fɛɐ̯ʃɛŋkn̩	4
verschicken	fɛɐ̯ʃɪkŋ̩	1
verschicken	fɛɐ̯ʃɪkən	1
verschieben	fɛrʃiːbən	1
verschlagen	fɛɐ̯ʃlaːɡn̩	1
verschlossen	fɛɐ̯ʃlɔsn̩	1
verschlossen	fɛɐ̯ʃlɔsən	1
verschlüsseln	fɛɐ̯ʃlʏsl̩n	2
verschlüsseln	fɛɐ̯ʃlʏsəln	2
verschlüsselt	fɛɐ̯ʃlʏsl̩t	5
verschlüsselt	fɛɐ̯ʃlʏsəlt	5
verschlüsselung	fɛɐ̯ʃlʏsəlʊŋ	6
verschulden	fɛɐ̯ʃʊldn̩	2
verschwinden	fɛɐ̯ʃvɪndn̩	4
verschwinden	fɛɐ̯ʃvɪndən	4
verschwörung	fɛɐ̯ʃvøːʁʊŋ	2
verschwörungstheorien	fɛɐ̯ʃvøːʁʊŋsteoʁiːən	1
verse	fɛʁzə	1
versenden	fɛɐzɛndn̩	4
versetzen	fɛɐ̯zɛtsn̩	4
versetzen	fɛɐ̯zɛtsən	4
versichern	fɛɐ̯zɪçɐn	2
versicherung	fɛɐ̯zɪçəʀʊŋ	1
versinken	fɛʁzɪŋkən	1
versöhnung	fɛɐ̯zøːnʊŋ	1
verspätet	fɛɐ̯ʃpɛːtət	1
verspätung	fɛɐ̯ʃpɛːtʊŋ	2
verspielen	fɛɐ̯ʃpiːlən	1
verspielen	fɐ-	1
versprechen	fɛɐ̯ʃpʁɛçən	3
versprechen	fɐ-	3
versprechen	fɛɐ̯ʃpʁɛçən	3
verständnis	fɛɐ̯ʃtɛntnɪs	4
verstecken	fɛɐ̯ʃtɛkən	4
verstecken	fɛɐ̯ʃtɛkn̩	4
verstopfung	fɛʁʃtɔpfʊŋ	1
verstört	fɛɐʃtøːɐt	1
verstossen	fɛɐ̯ʃtoːsn̩	1
verstossen	fɛɐ̯ʃtoːsən	1
verstricken	fɛɐ̯ʃtʀɪkən	1
versuch	fɛɐ̯zuːx	6
versuchen	fɛɐ̯zuːxən	14
verteidigen	fɛɐ̯taɪ̯dɪɡən	1
verteidiger	fɛɐ̯taɪ̯dɪɡɐ	6
verteidigung	fɛɐ̯taɪ̯dɪɡʊŋ	3
verteilen	fɛʁtaɪ̯lən	3
verteilung	fɛɐ̯taɪ̯lʊŋ	3
vertrag	fɛɐ̯tʁaːk	10
vertrag	fɐtʁax	10
vertrauen	fɛɐ̯tʀaʊ̯ən	9
vertrauen	fɛɐ̯tʀaʊ̯ən	9
vertraulich	fɛʁtʁaʊ̯lɪç	1
vertreter	fɛɐ̯tʁeːtɐ	9
vertrieb	fɛrtriːp	2
verve	vɛʁvə	1
verve	vɛʁf	1
verwalten	fɛɐ̯valtn̩	5
verwaltung	fɛʁvaltʊŋ	4
verwandeln	fɛɐ̯vandl̩n	3
verwandeln	fɛɐ̯vandəln	3
verwandt	fɛɐ̯vant	1
verwandt	fɐ-	1
verweigern	fɛʁvaɪ̯ɡəʁn	2
verweis	fɛɐ̯vaɪ̯s	1
verwenden	fɛɐ̯vɛndn̩	4
verwenden	fɛɐ̯vɛndən	4
verwendung	fɛɐ̯vɛndʊŋ	5
verwirren	fɛɐ̯vɪʀən	1
verwirrt	fɛɐ̯vɪʁt	2
verwüstung	fɛʁvyːstʊŋ	2
verzaubern	fɛʁtsaʊ̯bəʁn	1
verzehr	fɛɐ̯tseːɐ̯	1
verzückt	fɛɐ̯t͡sʏkt	1
verzweiflung	fɛɐ̯t͡svaɪ̯flʊŋ	2
veteran	veteʁaːn	1
vetter	fɛtɐ	2
vetter	fɛtər	2
vetternwirtschaft	fɛtɐnvɪrtʃaft	1
vieh	fiː	1
viel	fiːl	123
viele	fiːlə	136
vieles	fiːləs	8
vielfalt	fiːlfalt	6
vielleicht	filaɪ̯çt	43
vielleicht	fɪlaɪ̯çt	43
vielleicht	flaɪ̯çt	43
vielsprachig	fiːlʃpʁaːxɪç	1
vielversprechend	fiːlfɛɐ̯ʃpʁɛçn̩t	3
vielvölkerstaat	fiːlfœlkɐʃtaːt	1
vier	fiːɐ̯	68
vier	fiːɐ̯	68
vierte	fiːɐ̯tə	9
vierte	fɪʁtə	9
viertel	fɪʁtəl	1
viertel	fɪʁtəl	1
viertel	fɪtəl	1
vierzehn	fɪʁtseːn	1
vierzehn	fɪətsn̩	1
villach	fɪlaχ	1
vinophil	vinofiːl	1
violett	viːolɛt	1
visier	viziːr	6
vision	vizi̯oːn	4
vizekanzler	viːt͡səkant͡slɐ	2
vogel	foːɡəl	1
vögel	føːɡl̩	1
vögeln	føːɡl̩n	1
vögeln	føːɡəln	1
vögeln	føːɡl̩n	1
vögeln	føːɡəln	1
vogt	foːkt	1
vogt	foːxt	1
volk	fɔlk	6
völker	fœlkɐ	2
völkerrechtswidrig	fœlkɐʀɛçt͡sviːdʀɪç	2
volkes	fɔlkəs	3
volkspartei	fɔlkspaʁtaɪ̯	1
volksrepublik	fɔlksʀepubliːk	1
voll	fɔl	12
volleyball	vɔlibal	1
vollstreckung	fɔlʃtʀɛkʊŋ	1
volltextsuche	fɔltɛkstzuːxə	1
vollziehen	fɔlt͡siːən	2
vollzug	fɔltsuːk	2
vollzug	fɔltsuːk	2
volumen	voluːmən	2
von	fɔn	1546
vonnöten	fɔn‿nøːtn̩	1
vor	foːɐ̯	432
vorabend	foːɐ̯aːbənt	1
voran	foʁan	3
voran	fɔʁan	3
voraussetzung	foʁaʊ̯sɛtsʊŋ	3
vorbereiten	foːʁbəʁaɪ̯tən	1
vorderer	fɔʁdəʁɐ	1
vordergründig	fɔʁdɐɡʀʏndɪç	1
vorenthalten	foːɐ̯ʔɛnthaltn̩	1
vorfahren	foːɐ̯faːʀən	1
vorfahren	foːɐ̯faːʀən	1
vorfahrt	foːɐ̯faɐ̯t	1
vorfall	foːɐ̯fal	4
vorfreude	foːa̯fʀɔɪ̯də	2
vorführen	foːɐ̯fyːʁən	1
vorgang	foːɐ̯ɡaŋ	2
vorgänger	foːɐ̯ɡɛŋɐ	11
vorgehen	foːɐ̯ɡeːən	14
vorhaben	foːʁhaːbən	6
vorjahreszeitraum	foːɐ̯jaːʀəstsaɪ̯tʀaʊ̯m	2
vorlage	foːɐ̯laːɡə	9
vorlesen	foːɐ̯leːzn̩	2
vorm	foːɐ̯m	2
vormittag	foːɐ̯mɪtaːk	5
vormittag	fɔɐ̯mɪtax	5
vormonat	foːɐ̯moːnat	3
vorn	fɔʁn	6
vorn	fɔɐ̯n	6
vorne	fɔʁnə	17
vorne	fɔɐ̯nə	17
vornehmen	foːɐ̯neːmən	2
vorraum	foːɐ̯ʁaʊ̯m	1
vorsatz	foːɐ̯zat͡s	2
vorschlag	foːɐ̯ʃlax	8
vorschlag	foːɐ̯ʃlaːx	8
vorsetzen	foːɐ̯zɛt͡sn̩	1
vorsicht	foːʁzɪçt	3
vorsichtig	foːɐ̯zɪçtɪç	5
vorsitz	foːɐ̯zɪts	2
vorsitzender	foːɐ̯zɪt͡sn̩dɐ	4
vorstadt	foːɐ̯ʃtat	1
vorstellung	foːɐ̯ʃtɛlʊŋ	3
vorstufe	foːɐ̯ʃtuːfə	1
vorüber	foʀyːbɐ	1
vorübergehend	foʀyːbɐɡeːənt	6
vorurteil	foːɐ̯ʔʊʁtaɪ̯l	1
vorwerfen	foːʁvɛʁfən	1
vorwiegend	foːɐ̯viːɡənt	4
vorwurf	foːʁvʊʁf	5
w	veː	1
waage	vaːɡə	1
wache	vaχə	3
wache	vaχə	3
wachen	vaχən	1
wachsen	vaksn̩	3
wachsen	vaksən	3
wachstum	vakstuːm	15
wacken	vakn̩	1
wacker	vakɐ	1
waffe	vafə	5
waffen	vafɱ̩	9
waffen	vafən	9
wagen	vaːɡən	10
wagen	vaːɡən	10
wagner	vaːɡnɐ	1
wagnis	vaːknɪs	2
wahl	vaːl	25
wahlen	vaːlən	11
wählen	vɛːlən	16
wähler	vɛːlɐ	4
wahlurne	vaːlʔʊʁnə	1
wahnsinnig	vaːnzɪnɪç	2
wahr	vaːɐ̯	5
während	vɛːʁənt	71
währenddessen	vɛːʁəntdɛsn̩	1
wahrheit	vaːɐ̯haɪ̯t	9
wahrscheinlich	vaːɐ̯ʃaɪ̯nlɪç	9
wahrscheinlichkeit	vaːɐ̯ʃaɪ̯nlɪçkaɪ̯t	3
währung	vɛːʀʊŋ	3
währungen	vɛːʀʊŋən	3
wahrzeichen	vaːɐ̯t͡saɪ̯çn̩	1
waisen	vaɪ̯zn̩	1
waisen	vaɪ̯zən	1
wald	valt	3
walküre	valkyːʁə	1
walküre	valkyːʁə	1
wall	val	4
wams	vams	1
wand	vant	3
wände	vɛndə	1
wandel	vandl̩	3
wandel	vandəl	3
wandels	vandl̩s	2
wandels	vandəls	2
wandern	vandɐn	1
wanderung	vandəʁʊŋ	1
wanduhr	vantʔuːɐ̯	1
wann	van	10
war	vaːɐ̯	415
ware	vaːʀə	1
wäre	vɛːʀə	84
waren	vaːɐ̯n	143
waren	vaːʀən	143
wären	vɛːɐ̯n	10
wären	vɛːʀən	10
warm	varm	2
wärme	vɛʁmə	2
warnen	vaʁnən	4
warnen	vaːnən	4
warnen	vaːnn̩	4
warnung	vaʁnʊŋ	4
warten	vaʁtən	23
warten	vaːtən	23
warten	vaʁtən	23
wärter	vɛʁtɐ	1
warum	vaʁʊm	45
warum	vaːʁʊm	45
was	vas	243
waschen	vaʃən	3
wasser	vasɐ	8
wasserfall	vasɐfal	1
wasserstoff	vasɐʃtɔf	3
wat	vat	1
watt	vat	2
wayne	wɛɪ̯n	1
wayne	weːn	1
web	vɛp	2
weber	veːbɐ	4
website	vɛpsaɪ̯t	12
wechsel	vɛksl̩	15
wechsel	vɛksəl	15
wechselhaft	vɛksl̩haft	1
wecken	vɛkn̩	1
wecken	vɛkŋ̩	1
wecken	vɛkən	1
weder	veːdɐ	11
weg	vɛk	65
weg	vɛç	65
weg	veːk	65
weg	veːç	65
wegbereiterin	veːkbəʁaɪ̯təʁɪn	1
wegen	veːɡən	94
wegen	veːɡŋ̩	94
wegwerfen	vɛkvɛɐ̯fn̩	1
wehen	veːən	1
wehr	veːɐ̯	2
wehren	veːʀən	5
wehrmacht	veːʀmaxt	1
weibchen	vaɪ̯pçən	1
weichen	vaɪ̯çn̩	3
weichen	vaɪ̯çən	3
weichen	vaɪ̯çn̩	3
weichen	vaɪ̯çən	3
weiden	vaɪ̯dn̩	3
weidmann	vaɪ̯tman	1
weiher	vaɪ̯ɐ	1
weihnachten	vaɪ̯naxtən	5
weil	vaɪ̯l	121
weile	vaɪ̯lə	2
wein	vaɪ̯n	2
wein	vaɪ̯n	2
weinen	vaɪ̯nən	1
weinen	vaɪ̯nən	1
weise	vaɪ̯zə	17
weise	vaɪ̯zə	17
weisen	vaɪ̯zn̩	4
weisen	vaɪ̯zən	4
weisen	vaɪ̯zn̩	4
weisen	vaɪ̯zən	4
weiss	vaɪs	12
weit	vaɪ̯t	42
weitaus	vaɪ̯tʔaʊ̯s	3
weite	vaɪ̯tə	4
weite	vaɪ̯tə	4
weiten	vaɪ̯tn̩	1
weiten	vaɪ̯tən	1
weiter	vaɪ̯tɐ	110
weitergeben	vaɪ̯tɐɡeːbən	2
weizen	vaɪ̯tsən	1
welche	vɛlçə	37
welcher	vɛlçɐ	6
welle	vɛlə	2
welsch	vɛlʃ	1
welt	vɛlt	78
weltfremd	vɛltfʀɛmt	1
weltkrieg	vɛltkʁiːk	4
weltmeisterlich	vɛltmaɪ̯stɐlɪç	1
weltweit	vɛltvaɪ̯t	17
wem	veːm	1
wende	vɛndə	1
wenden	vɛndən	2
wenden	vɛndn̩	2
wenden	vɛndən	2
wenig	veːnɪç	44
wenige	veːnɪɡə	19
wenn	vɛn	279
wenngleich	vɛnɡlaɪç	2
wer	veːɐ̯	92
wer	vɛɐ̯	92
werbefrei	vɛʁbəfʀaɪ̯	2
werben	vɛʁbən	1
werden	veːɐ̯dn̩	608
werfen	vɛrfən	10
werk	vɛʁk	5
werkstatt	vɛʁkʃtat	2
werkzeug	vɛʁktsɔʏ̯k	1
wert	veːɐ̯t	27
wert	vɛɐ̯t	27
wert	vɛʁt	27
wert	veːɐ̯t	27
werte	vɛɐ̯tə	9
wertpapier	veːɐ̯tpapiːɐ̯	1
wertschätzung	veːɐ̯tʃɛt͡sʊŋ	1
wesentlich	veːzəntlɪç	5
weshalb	vɛshalp	7
weshalb	vɛshalp	7
west	vɛst	6
westen	vɛstən	13
westwärts	vɛstvɛʁts	1
wettbewerb	vɛtbəvɛʁp	9
wetten	vɛtən	2
wetter	vɛtɐ	15
wg	veːɡeː	1
whatsapp	vɔt͡sʔɛp	10
wichtig	vɪçtɪç	19
wichtig	vɪʃtɪʃ	19
wichtig	viçtik	19
wichtig	viçtik	19
wider	viːdɐ	3
widerlich	viːdɐlɪç	1
widerstand	viːdɐʃtant	14
widerstehen	viːdəʁʃteːn	1
widmen	vɪtmən	4
wie	viː	608
wieder	viːdɐ	220
wiederbelebung	viːdɐbəleːbʊŋ	1
wiedergeburt	viːdɐɡəbʊʁt	1
wiedergutmachung	viːdəʁɡuːtmaχʊŋ	1
wiederholen	viːdɐhoːln̩	4
wiederholen	viːdɐhoːlən	4
wiederholt	viːdɐhoːlt	1
wiedersehen	viːdɐzeːən	3
wiedersehen	viːdəʁzeːn	3
wien	viːn	27
wiese	viːzə	3
wiesen	viːzn̩	1
wieso	vizoː	6
wiktionary	vɪktʃənɛʀi	1
wiktionary	-ɹi	1
wiktionary	vɪktʃənʀiː	1
wiktionary	-ɹiː	1
wild	vɪlt	6
will	vɪl	137
willkommen	vɪlkɔmən	7
willkommenskultur	vɪlkɔmənskʊltuːɐ̯	1
wind	vɪnt	8
windows	wɪndoːs	28
windows	vɪndoːs	28
windows	wɪndɔs	28
windows	vɪndɔs	28
winter	vɪntɐ	13
winzer	vɪntsɐ	2
winzerin	vɪntsɐʁɪn	1
wir	viːɐ̯	357
wir	vɐ	357
wir	mɐ	357
wird	vɪɐ̯t	574
wirft	vɪʁft	7
wirft	vɪɐ̯ft	7
wirken	vɪʁkən	8
wirklich	vɪʁklɪç	49
wirklichkeit	vɪʁklɪçkaɪ̯t	2
wirksam	vɪʁkzaːm	1
wirr	vɪʁ	1
wirst	vɪʁst	2
wirt	vɪʁt	1
wirtin	vɪʁtɪn	1
wirtschaft	vɪʁtʃaft	29
wissen	vɪsn̩	41
wissen	vɪsən	41
wissen	vɪsən	41
wissenschaft	vɪsənʃaft	4
wissenschaftler	vɪsn̩ʃaftlɐ	7
wissenschaftler	vɪsənʃaftlɐ	7
wissensstand	vɪsənsʃtant	1
wlan	veːlaːn	3
wm	veʔɛm	8
wo	voː	80
woanders	voʔandɐs	2
wobei	vobaɪ̯	12
woche	vɔxə	66
wochen	vɔχn	44
wochenende	vɔχn̩ʔɛndə	26
wochenzeitung	vɔxn̩t͡saɪ̯tʊŋ	1
wofür	vofyːɐ̯	2
wog	voːk	1
woher	voheːɐ̯	2
wohl	voːl	59
wohnen	voːnən	10
wohnung	voːnʊŋ	21
wohnungen	voːnʊŋən	4
wohnungen	voːnʊŋn̩	4
wolfgang	vɔlfɡaŋk	18
wolfsburg	vɔlfsbʊʁk	21
wolken	vɔlkn	1
wolle	vɔlə	16
wolle	vɔlə	16
wollen	vɔlən	89
wollt	vɔlt	4
wollte	vɔltə	45
wollten	vɔltn̩	12
wollten	vɔltən	12
wort	vɔrt	5
wörter	vœʁtʰɐ	2
wrack	vʁak	2
wuchs	vuːks	4
wuchs	vʊks	4
wuchs	vuːks	4
wuchs	vʊks	4
wunde	vʊndə	1
wunder	vʊndəʁ	6
wunderbar	vʊndɐbaːɐ̯	1
wundern	vʊndɐn	2
wundersam	vʊndɐzaːm	1
wundervoll	vʊndɐfɔl	1
wunsch	vʊnʃ	8
wünschen	vʏnʃən	5
wurde	vʊʁdə	282
würde	vʏʁdə	62
würden	vʏʁdn̩	49
würden	vʏʁdən	49
würdigen	vʏʁdɪɡn̩	1
wurst	vʊʁst	3
würzburg	vʏɐ̯tsbʊɐ̯k	1
wusste	vʊstə	4
wut	vuːt	3
wütend	vyːtn̩t	2
wütend	vyːtənt	2
x	ʔɪks	10
youtube	juːtjuːp	11
youtube	juːtjuːb	11
z	tsɛt	4
zacken	t͡sakn̩	1
zäh	tsɛː	1
zäh	tseː	1
zahl	tsaːl	25
zahl	tsaːl	25
zahlen	tsaːln̩	33
zahlen	tsaːlən	33
zählen	t͡sɛːlən	11
zähler	t͡sɛːlɐ	4
zahlt	tsaːlt	6
zahlten	tsaːltn̩	1
zahlten	tsaːltən	1
zahm	t͡saːm	1
zecke	tsɛkə	1
zehn	tseːn	47
zehnmal	t͡seːnmaːl	1
zehnte	tseːntə	4
zeichen	tsaɪ̯çn̩	13
zeichen	tsaɪ̯çən	13
zeichnen	t͡saɪ̯çnən	3
zeichner	tsaɪ̯çnɐ	2
zeichnet	t͡saɪ̯çnət	4
zeichnung	t͡saɪ̯çnʊŋ	1
zeigefinger	tsaɪ̯ɡəfɪŋɐ	1
zeigen	t͡saɪ̯ɡən	42
zeiger	t͡saɪ̯ɡɐ	1
zeigt	tsaɪ̯kt	48
zeigt	tsaɪ̯çt	48
zeilen	tsaɪ̯ln̩	3
zeilen	tsaɪ̯lən	3
zeitalter	tsaɪ̯tʔaltɐ	3
zeitalters	tsaɪ̯tʔaltɐs	1
zeitfenster	t͡saɪ̯tfɛnstɐ	1
zeitpunkt	tsaɪ̯tpʊŋkt	11
zeitraum	tsaɪ̯tʀaʊ̯m	9
zeitung	t͡saɪ̯tʊŋ	28
zeitung	t͡saɪ̯tʊŋk	28
zeitungen	t͡saɪ̯tʊŋən	4
zeitweilig	t͡saɪ̯tvaɪ̯lɪç	2
zelle	tsɛlə	3
zementieren	t͡semɛntiːʁən	1
zensur	t͡sɛnzuːɐ̯	2
zentimeter	t͡sɛntimeːtər	9
zentral	t͡sɛntʀaːl	5
zentrum	t͡sɛntʁʊm	6
zepter	t͡sɛptɐ	1
zeremonie	t͡seʁemoniː	1
zeremonie	t͡seʁemoːni̯ə	1
zerren	tsɛrən	1
zettel	t͡sɛtəl	2
zeug	t͡sɔʏ̯k	4
zeug	t͡sɔʏ̯ç	4
zeuge	t͡sɔɪ̯ɡə	3
zeugen	t͡sɔʏ̯ɡən	8
zeugin	tsɔʏ̯ɡɪn	1
ziege	t͡siːɡə	1
ziegen	tsiːɡŋ̩	2
ziegen	tsiːɡən	2
ziehen	tsiːən	18
ziehen	tsiːn	18
ziehung	tsiːʊŋ	1
ziel	tsiːl	45
zielen	tsiːln̩	1
zielen	tsiːlən	1
ziemlich	tsiːmlɪç	14
ziemlich	tsɪmlɪç	14
zimmer	t͡sɪmɐ	5
zimmermann	t͡sɪmɐman	1
zimmern	tsɪmɐn	3
zimmern	tsɪmɐn	3
zimt	t͡sɪmt	1
zinn	tsɪn	1
zins	t͡sɪns	1
zitat	t͡sitaːt	2
zitronen	t͡sitʁoːnn̩	1
zittern	t͡sɪtɐn	2
zocken	tsɔkən	1
zoll	tsɔl	6
zombie	t͡sɔmbi	1
zone	tsoːnə	2
zoom	zuːm	1
zoonosen	t͡soonoːzn̩	2
zorn	tsɔrn	1
zu	t͡suː	1388
zu	t͡sə	1388
zucker	tsʊkɐ	2
zuerst	tsuʔeːɐ̯st	13
zufall	t͡suːfal	3
zufällig	t͡suːfɛlɪç	4
zufällig	t͡suːfɛlɪk	4
zufälligerweise	t͡suːfɛlɪɡɐvaɪ̯zə	1
zuflucht	t͡suːflʊxt	1
zufolge	tsufɔlɡə	24
zug	t͡suːk	17
zug	t͡sux	17
zug	t͡suːx	17
zugang	t͡suːɡaŋ	10
zugänglich	tsuːɡɛŋlɪç	4
zugehen	tsuːɡeːən	1
zügeln	tsyːɡl̩n	1
zügeln	tsyːɡəln	1
zugleich	t͡suɡlaɪ̯ç	16
zugreifen	tsuːɡʁaɪ̯fən	2
zugunsten	tsuɡʊnstn̩	3
zugunsten	tsuɡʊnstən	3
zugzwang	tsuːktsvaŋ	1
zuhälter	t͡suːhɛltɐ	1
zuhause	t͡suhaʊ̯zə	5
zuhören	tsuːhøːʁən	1
zukunft	tsuːkʊnft	36
zukunft	tsuːkʊmft	36
zulassen	tsuːlasn̩	4
zulassen	tsuːlasən	4
zuletzt	t͡sulɛt͡st	36
zum	tsuːm	454
zum	tsʊm	454
zum	tsʊm	454
zumindest	t͡sumɪndəst	29
zuneigung	tsuːnaɪɡʊŋ	1
zunge	tsʊŋə	1
zuordnen	tsuːɔʁtnən	1
zupfen	tsʊpfən	1
zur	tsuːɐ̯	265
zürcher	t͡sʏʁçɐ	7
zürich	tsyːrɪç	18
zürich	tsʏrɪç	18
zurück	t͡suʁʏk	65
zurückgeben	tsuʀʏkɡeːbm̩	1
zurückgeben	tsuʀʏkɡeːbən	1
zurückhalten	tsuʀʏkhaltn̩	3
zurückhalten	tsuʀʏkhaltən	3
zurückkehren	tsuʁʏkkeːʁən	1
zurzeit	tsʊrtsaɪt	5
zusammen	tsuzamən	40
zusammen	tsəzamən	40
zusammen	tsamən	40
zusammenbruch	t͡suzamənbʀʊχ	1
zusammenfallen	tsuzamənfalən	1
zusammenfassung	t͡suzamənfasʊŋ	1
zusammengesetzt	tsuzamənɡəzɛtst	1
zusammenhalt	tsuzamənhalt	1
zusammenkommen	tsuzamənkɔmən	3
zusammenkunft	t͡suzamənkʊnft	1
zusammenstellen	tsuzamənʃtɛlən	1
zusammenstellung	tsuzamənʃtɛlʊŋ	1
zuschauer	t͡suːʃaʊ̯ɐ	14
zuspruch	t͡suːʃpʁʊx	3
zustand	t͡suːʃtant	11
zustimmen	tsuːʃtɪmən	2
zustimmung	t͡suːʃtɪmʊŋ	2
zutiefst	tsutiːfst	2
zuverlässig	t͡suːfɛɐ̯lɛsɪç	3
zuverlässigkeit	t͡suːfɛɐ̯lɛsɪçkaɪ̯t	2
zuversicht	t͜suːfɛɐzɪçt	2
zuvor	t͡sufoːɐ̯	40
zuwanderer	tsuːvandəʀɐ	1
zuweisung	t͡suːvaɪ̯zʊŋ	1
zuzüglich	tsuːtsyːkliç	1
zwanzig	t͡svant͡sɪç	1
zwar	t͡svaːɐ̯	56
zweck	t͡svɛk	5
zwecklos	tsvɛkloːs	1
zwecks	tsvɛks	1
zwei	t͡svaɪ̯	173
zwei	t͡svaɪ	173
zweier	tsvaɪ̯ɐ	7
zweifel	t͡svaɪ̯fl̩	3
zweifeln	tsvaɪ̯fl̩n	1
zweifeln	tsvaɪ̯fəln	1
zweimal	t͡svaɪ̯maːl	6
zweit	tsvaɪ̯t	2
zwiebel	tsviːbəl	1
zwietracht	tsviːtʁaxt	1
zwingen	tsvɪŋən	2
zwingend	t͡svɪŋənt	2
zwischen	tsvɪʃən	102
zwölf	tsvœlf	18
zwölfmal	t͡svœlfmaːl	2
zynisch	t͡syːnɪʃ	1
zynismus	t͡syːnɪsmʊs	1
zypern	tsyːpɐn	3
